"","Player","TotalRuns","Total4s","Total6s","TotalBoundaries","RunsFrom4s","RunsFrom6s","RunsFromBoundaries","PropFrom4s","PropFrom6s","PropFromBoundaries"
"1","A Bacher (SA)",679,49,0,49,196,0,196,0.288659793814433,0,0.288659793814433
"2","A Balbirnie (IRE)",0,0,0,0,0,0,0,NA,NA,NA
"3","A Brown (ENG)",3,0,0,0,0,0,0,0,0,0
"4","A Chopra (INDIA)",437,49,0,49,196,0,196,0.448512585812357,0,0.448512585812357
"5","A Coningham (AUS)",13,0,0,0,0,0,0,0,0,0
"6","A Cotter (AUS)",461,30,5,35,120,30,150,0.260303687635575,0.0650759219088937,0.325379609544469
"7","A Coxon (ENG)",19,0,0,0,0,0,0,0,0,0
"8","A D'Souza (PAK)",76,1,0,1,4,0,4,0.0526315789473684,0,0.0526315789473684
"9","A Dananjaya (SL)",88,11,0,11,44,0,44,0.5,0,0.5
"10","A Dolphin (ENG)",1,0,0,0,0,0,0,0,0,0
"11","A Ducat (ENG)",5,0,0,0,0,0,0,0,0,0
"12","A Fielder (ENG)",78,3,0,3,12,0,12,0.153846153846154,0,0.153846153846154
"13","A Flintoff (ENG)",3795,511,78,589,2044,468,2512,0.538603425559947,0.123320158102767,0.661923583662714
"14","A Flintoff (ICC)",50,2,4,6,8,24,32,0.16,0.48,0.64
"15","A Flower (ZIM)",4794,543,20,563,2172,120,2292,0.453066332916145,0.0250312891113892,0.478097622027534
"16","A Gandotra (INDIA)",54,0,0,0,0,0,0,0,0,0
"17","A Greenwood (ENG)",77,0,0,0,0,0,0,0,0,0
"18","A Habib (ENG)",26,4,0,4,16,0,16,0.615384615384615,0,0.615384615384615
"19","A Hearne (ENG)",9,0,0,0,0,0,0,0,0,0
"20","A Hill (ENG)",101,3,0,3,12,0,12,0.118811881188119,0,0.118811881188119
"21","A Hurwood (AUS)",5,0,0,0,0,0,0,0,0,0
"22","A Jackson (AUS)",474,29,0,29,116,0,116,0.244725738396624,0,0.244725738396624
"23","A Jadeja (INDIA)",576,62,3,65,248,18,266,0.430555555555556,0.03125,0.461805555555556
"24","A Kumble (INDIA)",2506,302,9,311,1208,54,1262,0.482043096568236,0.0215482841181165,0.503591380686353
"25","A Kuruvilla (INDIA)",66,0,4,4,0,24,24,0,0.363636363636364,0.363636363636364
"26","A Lyth (ENG)",265,40,1,41,160,6,166,0.60377358490566,0.0226415094339623,0.626415094339623
"27","A Maregwede (ZIM)",74,10,2,12,40,12,52,0.540540540540541,0.162162162162162,0.702702702702703
"28","A McGrath (ENG)",201,27,1,28,108,6,114,0.537313432835821,0.0298507462686567,0.567164179104478
"29","A Melville (SA)",894,71,1,72,284,6,290,0.317673378076063,0.00671140939597315,0.324384787472036
"30","A Mishra (INDIA)",648,79,3,82,316,18,334,0.487654320987654,0.0277777777777778,0.515432098765432
"31","A Mitchell (ENG)",298,0,0,0,0,0,0,0,0,0
"32","A Mithun (INDIA)",120,16,0,16,64,0,64,0.533333333333333,0,0.533333333333333
"33","A Mukund (INDIA)",320,32,1,33,128,6,134,0.4,0.01875,0.41875
"34","A Nehra (INDIA)",77,8,3,11,32,18,50,0.415584415584416,0.233766233766234,0.649350649350649
"35","A Nel (SA)",337,40,5,45,160,30,190,0.474777448071217,0.0890207715133531,0.56379821958457
"36","A Ranatunga (SL)",5059,547,39,586,2188,234,2422,0.432496540818344,0.0462542004348686,0.478750741253212
"37","A Ratra (INDIA)",163,14,0,14,56,0,56,0.343558282208589,0,0.343558282208589
"38","A Rose-Innes (SA)",14,1,0,1,4,0,4,0.285714285714286,0,0.285714285714286
"39","A Sandham (ENG)",875,37,0,37,148,0,148,0.169142857142857,0,0.169142857142857
"40","A Sanford (WI)",72,7,2,9,28,12,40,0.388888888888889,0.166666666666667,0.555555555555556
"41","A Shahzad (ENG)",5,1,0,1,4,0,4,0.8,0,0.8
"42","A Shaw (ENG)",111,7,0,7,28,0,28,0.252252252252252,0,0.252252252252252
"43","A Shrewsbury snr (ENG)",1277,90,0,90,360,0,360,0.281910728269381,0,0.281910728269381
"44","A Sidebottom (ENG)",2,0,0,0,0,0,0,0,0,0
"45","A Symonds (AUS)",1462,154,28,182,616,168,784,0.421340629274966,0.114911080711354,0.53625170998632
"46","A Turner (AUS)",768,79,2,81,316,12,328,0.411458333333333,0.015625,0.427083333333333
"47","A Waddington (ENG)",16,1,0,1,4,0,4,0.25,0,0.25
"48","A Ward (ENG)",527,37,1,38,148,6,154,0.280834914611006,0.0113851992409867,0.292220113851992
"49","A Warren (ENG)",7,0,0,0,0,0,0,0,0,0
"50","A Wharton (ENG)",20,0,0,0,0,0,0,0,0,0
"51","A Wood (ENG)",80,8,0,8,32,0,32,0.4,0,0.4
"52","AA Baig (INDIA)",428,24,0,24,96,0,96,0.224299065420561,0,0.224299065420561
"53","AA Donald (SA)",652,66,0,66,264,0,264,0.404907975460123,0,0.404907975460123
"54","AA Mailey (AUS)",218,15,0,15,60,0,60,0.275229357798165,0,0.275229357798165
"55","AA Mallett (AUS)",430,40,0,40,160,0,160,0.372093023255814,0,0.372093023255814
"56","Aamer Malik (PAK)",565,66,2,68,264,12,276,0.467256637168142,0.0212389380530973,0.488495575221239
"57","Aamer Nazir (PAK)",31,4,0,4,16,0,16,0.516129032258065,0,0.516129032258065
"58","Aamer Sohail (PAK)",2685,354,8,362,1416,48,1464,0.527374301675978,0.017877094972067,0.545251396648045
"59","Aaqib Javed (PAK)",101,11,0,11,44,0,44,0.435643564356436,0,0.435643564356436
"60","AB Agarkar (INDIA)",571,83,3,86,332,18,350,0.581436077057793,0.031523642732049,0.612959719789842
"61","AB Barath (WI)",657,93,5,98,372,30,402,0.5662100456621,0.045662100456621,0.611872146118721
"62","AB de Villiers (SA)",8765,1024,64,1088,4096,384,4480,0.467313177410154,0.0438106103822019,0.511123787792356
"63","AB Fudadin (WI)",122,15,0,15,60,0,60,0.491803278688525,0,0.491803278688525
"64","AB McDonald (AUS)",107,11,0,11,44,0,44,0.411214953271028,0,0.411214953271028
"65","AB Tancred (SA)",87,8,0,8,32,0,32,0.367816091954023,0,0.367816091954023
"66","AB Williams (WI)",469,43,0,43,172,0,172,0.366737739872068,0,0.366737739872068
"67","Abdul Kadir (PAK)",272,21,0,21,84,0,84,0.308823529411765,0,0.308823529411765
"68","Abdul Qadir (PAK)",1029,99,16,115,396,96,492,0.384839650145773,0.0932944606413994,0.478134110787172
"69","Abdul Razzaq (PAK)",1946,230,23,253,920,138,1058,0.472764645426516,0.0709146968139774,0.543679342240493
"70","Abdur Rauf (PAK)",52,4,0,4,16,0,16,0.307692307692308,0,0.307692307692308
"71","Abdur Razzak (BDESH)",248,30,6,36,120,36,156,0.483870967741935,0.145161290322581,0.629032258064516
"72","Abdur Rehman (PAK)",395,47,9,56,188,54,242,0.475949367088608,0.136708860759494,0.612658227848101
"73","Abu Jayed (BDESH)",2,0,0,0,0,0,0,0,0,0
"74","Abul Hasan (BDESH)",165,17,5,22,68,30,98,0.412121212121212,0.181818181818182,0.593939393939394
"75","AC Agar (AUS)",195,24,3,27,96,18,114,0.492307692307692,0.0923076923076923,0.584615384615385
"76","AC Bannerman (AUS)",1108,80,1,81,320,6,326,0.288808664259928,0.00541516245487365,0.294223826714801
"77","AC Cummins (WI)",98,9,0,9,36,0,36,0.36734693877551,0,0.36734693877551
"78","AC Dale (AUS)",6,0,0,0,0,0,0,0,0,0
"79","AC Dawson (SA)",10,1,0,1,4,0,4,0.4,0,0.4
"80","AC Gilchrist (AUS)",5570,677,100,777,2708,600,3308,0.486175942549372,0.107719928186715,0.593895870736086
"81","AC Hudson (SA)",2007,254,5,259,1016,30,1046,0.506228201295466,0.0149476831091181,0.521175884404584
"82","AC MacLaren (ENG)",1931,148,0,148,592,0,592,0.306576903158985,0,0.306576903158985
"83","AC Parore (NZ)",2773,309,9,318,1236,54,1290,0.445726649837721,0.0194734944103859,0.465200144248107
"84","AC Smith (ENG)",118,15,0,15,60,0,60,0.508474576271186,0,0.508474576271186
"85","AC Voges (AUS)",1485,186,5,191,744,30,774,0.501010101010101,0.0202020202020202,0.521212121212121
"86","AC Waller (ZIM)",69,6,2,8,24,12,36,0.347826086956522,0.173913043478261,0.521739130434783
"87","ACB Langton (SA)",298,0,4,4,0,24,24,0,0.0805369127516778,0.0805369127516778
"88","ACI Lock (ZIM)",8,2,0,2,8,0,8,1,0,1
"89","ACS Pigott (ENG)",12,1,0,1,4,0,4,0.333333333333333,0,0.333333333333333
"90","AD Gaekwad (INDIA)",1985,109,0,109,436,0,436,0.219647355163728,0,0.219647355163728
"91","AD Hales (ENG)",573,77,3,80,308,18,326,0.537521815008726,0.031413612565445,0.568935427574171
"92","AD Mathews (SL)",5073,556,54,610,2224,324,2548,0.438399369209541,0.0638675340035482,0.502266903213089
"93","AD Mullally (ENG)",127,18,2,20,72,12,84,0.566929133858268,0.094488188976378,0.661417322834646
"94","AD Nourse (SA)",2960,158,6,164,632,36,668,0.213513513513514,0.0121621621621622,0.225675675675676
"95","AD Ogilvie (AUS)",178,17,0,17,68,0,68,0.382022471910112,0,0.382022471910112
"96","AD Pougher (ENG)",17,0,0,0,0,0,0,0,0,0
"97","AD Russell (WI)",2,0,0,0,0,0,0,0,0,0
"98","ADG Matthews (ENG)",2,0,0,0,0,0,0,0,0,0
"99","ADG Roberts (NZ)",254,14,1,15,56,6,62,0.220472440944882,0.0236220472440945,0.244094488188976
"100","Adnan Akmal (PAK)",591,73,0,73,292,0,292,0.494077834179357,0,0.494077834179357
"101","ADR Campbell (ZIM)",2858,355,4,359,1420,24,1444,0.496850944716585,0.00839748075577327,0.505248425472358
"102","AE Dick (NZ)",370,29,0,29,116,0,116,0.313513513513514,0,0.313513513513514
"103","AE Dipper (ENG)",51,3,0,3,12,0,12,0.235294117647059,0,0.235294117647059
"104","AE Fagg (ENG)",150,1,0,1,4,0,4,0.0266666666666667,0,0.0266666666666667
"105","AE Greenidge (WI)",222,21,1,22,84,6,90,0.378378378378378,0.027027027027027,0.405405405405405
"106","AE Hall (SA)",11,0,0,0,0,0,0,0,0,0
"107","AE Knight (ENG)",81,7,0,7,28,0,28,0.345679012345679,0,0.345679012345679
"108","AE Moss (ENG)",61,1,1,2,4,6,10,0.0655737704918033,0.0983606557377049,0.163934426229508
"109","AE Ochse (SA)",16,1,0,1,4,0,4,0.25,0,0.25
"110","AE Relf (ENG)",416,28,0,28,112,0,112,0.269230769230769,0,0.269230769230769
"111","AE Stoddart (ENG)",996,58,5,63,232,30,262,0.232931726907631,0.0301204819277108,0.263052208835341
"112","AE Trott (AUS)",205,22,1,23,88,6,94,0.429268292682927,0.0292682926829268,0.458536585365854
"113","AE Trott (ENG)",23,0,0,0,0,0,0,0,0,0
"114","AEE Vogler (SA)",340,15,6,21,60,36,96,0.176470588235294,0.105882352941176,0.282352941176471
"115","AER Gilligan (ENG)",205,8,1,9,32,6,38,0.15609756097561,0.0292682926829268,0.185365853658537
"116","AEV Hartkopf (AUS)",80,8,0,8,32,0,32,0.4,0,0.4
"117","AF Giles (ENG)",1421,175,5,180,700,30,730,0.492610837438424,0.0211118930330753,0.513722730471499
"118","AF Kippax (AUS)",1192,97,1,98,388,6,394,0.325503355704698,0.00503355704697987,0.330536912751678
"119","AF Lissette (NZ)",2,0,0,0,0,0,0,0,0,0
"120","AF Rae (WI)",1016,58,4,62,232,24,256,0.228346456692913,0.0236220472440945,0.251968503937008
"121","AFA Lilley (ENG)",903,35,0,35,140,0,140,0.155038759689922,0,0.155038759689922
"122","Afaq Hussain (PAK)",66,8,0,8,32,0,32,0.484848484848485,0,0.484848484848485
"123","AFG Griffith (WI)",638,65,1,66,260,6,266,0.407523510971787,0.00940438871473354,0.41692789968652
"124","Afsar Zazai (AFG)",7,1,0,1,4,0,4,0.571428571428571,0,0.571428571428571
"125","Aftab Ahmed (BDESH)",582,78,3,81,312,18,330,0.536082474226804,0.0309278350515464,0.56701030927835
"126","Aftab Baloch (PAK)",97,3,0,3,12,0,12,0.123711340206186,0,0.123711340206186
"127","Aftab Gul (PAK)",182,16,0,16,64,0,64,0.351648351648352,0,0.351648351648352
"128","AG Archer (ENG)",31,0,0,0,0,0,0,0,0,0
"129","AG Barrett (WI)",40,1,0,1,4,0,4,0.1,0,0.1
"130","AG Chipperfield (AUS)",552,32,0,32,128,0,128,0.231884057971014,0,0.231884057971014
"131","AG Cremer (ZIM)",540,47,2,49,188,12,200,0.348148148148148,0.0222222222222222,0.37037037037037
"132","AG Fairfax (AUS)",410,17,1,18,68,6,74,0.165853658536585,0.0146341463414634,0.180487804878049
"133","AG Ganteaume (WI)",112,13,0,13,52,0,52,0.464285714285714,0,0.464285714285714
"134","AG Huckle (ZIM)",74,10,0,10,40,0,40,0.540540540540541,0,0.540540540540541
"135","AG Hurst (AUS)",102,10,1,11,40,6,46,0.392156862745098,0.0588235294117647,0.450980392156863
"136","AG Kripal Singh (INDIA)",422,6,0,6,24,0,24,0.0568720379146919,0,0.0568720379146919
"137","AG Milkha Singh (INDIA)",92,0,0,0,0,0,0,0,0,0
"138","AG Prince (SA)",3665,397,13,410,1588,78,1666,0.433287858117326,0.0212824010914052,0.454570259208731
"139","AG Steel (ENG)",600,51,0,51,204,0,204,0.34,0,0.34
"140","AGD Wickremasinghe (SL)",17,2,0,2,8,0,8,0.470588235294118,0,0.470588235294118
"141","Agha Saadat Ali (PAK)",8,0,0,0,0,0,0,0,0,0
"142","Agha Zahid (PAK)",15,0,0,0,0,0,0,0,0,0
"143","AH Bakewell (ENG)",409,4,1,5,16,6,22,0.039119804400978,0.0146699266503667,0.0537897310513447
"144","AH Gray (WI)",48,5,0,5,20,0,20,0.416666666666667,0,0.416666666666667
"145","AH Jarvis (AUS)",303,12,0,12,48,0,48,0.158415841584158,0,0.158415841584158
"146","AH Jones (NZ)",2922,245,8,253,980,48,1028,0.335386721423682,0.0164271047227926,0.351813826146475
"147","AH Kardar (INDIA)",80,0,0,0,0,0,0,0,0,0
"148","AH Kardar (PAK)",847,7,2,9,28,12,40,0.0330578512396694,0.0141676505312869,0.0472255017709563
"149","AH McKinnon (SA)",107,9,1,10,36,6,42,0.336448598130841,0.0560747663551402,0.392523364485981
"150","AH Omarshah (ZIM)",122,13,1,14,52,6,58,0.426229508196721,0.0491803278688525,0.475409836065574
"151","AHC Cooper (SA)",6,0,0,0,0,0,0,0,0,0
"152","AHH Gilligan (ENG)",71,0,0,0,0,0,0,0,0,0
"153","Ahmed Shehzad (PAK)",982,99,8,107,396,48,444,0.403258655804481,0.0488798370672098,0.45213849287169
"154","AHP Scott (WI)",5,0,0,0,0,0,0,0,0,0
"155","AI Kallicharran (WI)",4445,474,12,486,1896,72,1968,0.426546681664792,0.0161979752530934,0.442744656917885
"156","AI Taylor (SA)",18,0,0,0,0,0,0,0,0,0
"157","AIC Dodemaide (AUS)",202,14,0,14,56,0,56,0.277227722772277,0,0.277227722772277
"158","Aizaz Cheema (PAK)",1,0,0,0,0,0,0,0,0,0
"159","AJ Bell (SA)",69,0,0,0,0,0,0,0,0,0
"160","AJ Bichel (AUS)",355,51,2,53,204,12,216,0.574647887323944,0.0338028169014084,0.608450704225352
"161","AJ Doolan (AUS)",191,26,1,27,104,6,110,0.544502617801047,0.031413612565445,0.575916230366492
"162","AJ Evans (ENG)",14,1,0,1,4,0,4,0.285714285714286,0,0.285714285714286
"163","AJ Fothergill (ENG)",33,3,1,4,12,6,18,0.363636363636364,0.181818181818182,0.545454545454545
"164","AJ Hall (SA)",760,96,4,100,384,24,408,0.505263157894737,0.0315789473684211,0.536842105263158
"165","AJ Hollioake (ENG)",65,7,1,8,28,6,34,0.430769230769231,0.0923076923076923,0.523076923076923
"166","AJ Lamb (ENG)",4748,628,21,649,2512,126,2638,0.529064869418703,0.0265374894692502,0.555602358887953
"167","AJ McKay (NZ)",25,3,0,3,12,0,12,0.48,0,0.48
"168","AJ Pithey (SA)",819,67,2,69,268,12,280,0.327228327228327,0.0146520146520147,0.341880341880342
"169","AJ Pycroft (ZIM)",106,11,0,11,44,0,44,0.415094339622642,0,0.415094339622642
"170","AJ Redmond (NZ)",325,46,2,48,184,12,196,0.566153846153846,0.0369230769230769,0.603076923076923
"171","AJ Richardson (AUS)",399,33,0,33,132,0,132,0.330827067669173,0,0.330827067669173
"172","AJ Stewart (ENG)",8417,1113,10,1123,4452,60,4512,0.52892954734466,0.00712843055720566,0.536057977901865
"173","AJ Strauss (ENG)",7037,867,10,877,3468,60,3528,0.492823646440244,0.00852636066505613,0.501350007105301
"174","AJ Traicos (SA)",8,0,0,0,0,0,0,0,0,0
"175","AJ Traicos (ZIM)",11,2,0,2,8,0,8,0.727272727272727,0,0.727272727272727
"176","AJ Tudor (ENG)",229,39,0,39,156,0,156,0.681222707423581,0,0.681222707423581
"177","AJ Watkins (ENG)",810,17,0,17,68,0,68,0.0839506172839506,0,0.0839506172839506
"178","AJ Webbe (ENG)",4,0,0,0,0,0,0,0,0,0
"179","AJ Woodcock (AUS)",27,4,0,4,16,0,16,0.592592592592593,0,0.592592592592593
"180","AJL Hill (ENG)",251,0,0,0,0,0,0,0,0,0
"181","AJW McIntyre (ENG)",19,2,0,2,8,0,8,0.421052631578947,0,0.421052631578947
"182","AJY Hopkins (AUS)",509,23,3,26,92,18,110,0.180746561886051,0.0353634577603143,0.216110019646365
"183","AK Davidson (AUS)",1328,91,8,99,364,48,412,0.274096385542169,0.036144578313253,0.310240963855422
"184","AK Kuruppuarachchi (SL)",0,0,0,0,0,0,0,NA,NA,NA
"185","AK Markram (SA)",1040,138,5,143,552,30,582,0.530769230769231,0.0288461538461538,0.559615384615385
"186","AK Roy (INDIA)",91,10,0,10,40,0,40,0.43956043956044,0,0.43956043956044
"187","AK Sengupta (INDIA)",9,0,0,0,0,0,0,0,0,0
"188","AK Sharma (INDIA)",53,8,0,8,32,0,32,0.60377358490566,0,0.60377358490566
"189","Akram Khan (BDESH)",259,29,3,32,116,18,134,0.447876447876448,0.0694980694980695,0.517374517374517
"190","Akram Raza (PAK)",153,18,0,18,72,0,72,0.470588235294118,0,0.470588235294118
"191","Al-Amin Hossain (BDESH)",68,6,5,11,24,30,54,0.352941176470588,0.441176470588235,0.794117647058823
"192","AL Apte (INDIA)",15,0,0,0,0,0,0,0,0,0
"193","AL Hassett (AUS)",3073,240,8,248,960,48,1008,0.312398307842499,0.015619915392125,0.328018223234624
"194","AL Logie (WI)",2562,318,10,328,1272,60,1332,0.496487119437939,0.0234192037470726,0.519906323185012
"195","AL Mann (AUS)",189,16,1,17,64,6,70,0.338624338624339,0.0317460317460317,0.37037037037037
"196","AL Ochse (SA)",7,0,0,0,0,0,0,0,0,0
"197","AL Padmore (WI)",8,0,0,0,0,0,0,0,0,0
"198","AL Phehlukwayo (SA)",19,3,0,3,12,0,12,0.631578947368421,0,0.631578947368421
"199","Al Sahariar (BDESH)",683,99,4,103,396,24,420,0.579795021961933,0.0351390922401171,0.61493411420205
"200","AL Thomson (AUS)",22,2,0,2,8,0,8,0.363636363636364,0,0.363636363636364
"201","AL Valentine (WI)",141,4,3,7,16,18,34,0.113475177304965,0.127659574468085,0.24113475177305
"202","AL Wadekar (INDIA)",2113,217,2,219,868,12,880,0.41079034548036,0.0056791292001893,0.416469474680549
"203","Alamgir Kabir (BDESH)",8,1,0,1,4,0,4,0.5,0,0.5
"204","ALF de Mel (SL)",326,17,3,20,68,18,86,0.208588957055215,0.0552147239263804,0.263803680981595
"205","Ali Naqvi (PAK)",242,31,0,31,124,0,124,0.512396694214876,0,0.512396694214876
"206","Alimuddin (PAK)",1091,52,0,52,208,0,208,0.190650779101742,0,0.190650779101742
"207","Alok Kapali (BDESH)",584,80,3,83,320,18,338,0.547945205479452,0.0308219178082192,0.578767123287671
"208","AM Bacher (SA)",787,99,3,102,396,18,414,0.503176620076239,0.0228716645489199,0.526048284625159
"209","AM Blignaut (ZIM)",886,102,23,125,408,138,546,0.460496613995485,0.155756207674944,0.616252821670429
"210","AM de Silva (SL)",10,1,0,1,4,0,4,0.4,0,0.4
"211","AM Matheson (NZ)",7,0,0,0,0,0,0,0,0,0
"212","AM Miller (ENG)",24,0,0,0,0,0,0,0,0,0
"213","AM Moir (NZ)",327,17,2,19,68,12,80,0.207951070336391,0.036697247706422,0.244648318042813
"214","AM Pai (INDIA)",10,2,0,2,8,0,8,0.8,0,0.8
"215","AM Rahane (INDIA)",3113,354,23,377,1416,138,1554,0.454866688082236,0.0443302280758111,0.499196916158047
"216","AM Smith (ENG)",4,1,0,1,4,0,4,1,0,1
"217","AMB Rowan (SA)",290,2,1,3,8,6,14,0.0275862068965517,0.0206896551724138,0.0482758620689655
"218","AME Roberts (WI)",762,54,22,76,216,132,348,0.283464566929134,0.173228346456693,0.456692913385827
"219","Aminul Islam (BDESH)",530,50,0,50,200,0,200,0.377358490566038,0,0.377358490566038
"220","Amir Elahi (INDIA)",17,2,0,2,8,0,8,0.470588235294118,0,0.470588235294118
"221","Amir Elahi (PAK)",65,0,0,0,0,0,0,0,0,0
"222","AMJ Hilditch (AUS)",1073,103,4,107,412,24,436,0.383970177073625,0.0223671947809879,0.406337371854613
"223","AMJG Amerasinghe (SL)",54,8,0,8,32,0,32,0.592592592592593,0,0.592592592592593
"224","AN Connolly (AUS)",260,17,8,25,68,48,116,0.261538461538462,0.184615384615385,0.446153846153846
"225","AN Cook (ENG)",12325,1428,11,1439,5712,66,5778,0.463448275862069,0.00535496957403651,0.468803245436105
"226","AN Hornby (ENG)",21,1,0,1,4,0,4,0.19047619047619,0,0.19047619047619
"227","AN Petersen (SA)",2093,256,12,268,1024,72,1096,0.489249880554228,0.0344003822264692,0.523650262780698
"228","AN Ranasinghe (SL)",88,1,0,1,4,0,4,0.0454545454545455,0,0.0454545454545455
"229","Anamul Haque (BDESH)",73,8,0,8,32,0,32,0.438356164383562,0,0.438356164383562
"230","Anil Dalpat (PAK)",167,20,0,20,80,0,80,0.479041916167665,0,0.479041916167665
"231","Anwar Hossain (BDESH)",14,2,0,2,8,0,8,0.571428571428571,0,0.571428571428571
"232","Anwar Hossain Monir (BDESH)",22,2,0,2,8,0,8,0.363636363636364,0,0.363636363636364
"233","Anwar Hussain (PAK)",42,0,0,0,0,0,0,0,0,0
"234","Anwar Khan (PAK)",15,0,1,1,0,6,6,0,0.4,0.4
"235","AO Jones (ENG)",291,7,0,7,28,0,28,0.0962199312714777,0,0.0962199312714777
"236","AO Malhotra (INDIA)",226,18,0,18,72,0,72,0.31858407079646,0,0.31858407079646
"237","AP Binns (WI)",64,0,0,0,0,0,0,0,0,0
"238","AP Freeman (ENG)",154,10,0,10,40,0,40,0.25974025974026,0,0.25974025974026
"239","AP Gurusinha (SL)",2406,244,11,255,976,66,1042,0.405652535328346,0.027431421446384,0.43308395677473
"240","AP Igglesden (ENG)",6,0,0,0,0,0,0,0,0,0
"241","AP Kuiper (SA)",34,4,0,4,16,0,16,0.470588235294118,0,0.470588235294118
"242","AP Lucas (ENG)",157,7,0,7,28,0,28,0.178343949044586,0,0.178343949044586
"243","AP Marr (AUS)",5,1,0,1,4,0,4,0.8,0,0.8
"244","AP Sheahan (AUS)",1594,156,2,158,624,12,636,0.391468005018821,0.00752823086574655,0.398996235884567
"245","AP Wells (ENG)",3,0,0,0,0,0,0,0,0,0
"246","APE Knott (ENG)",4389,491,6,497,1964,36,2000,0.447482342219184,0.00820232399179768,0.455684666210982
"247","APF Chapman (ENG)",925,73,12,85,292,72,364,0.315675675675676,0.0778378378378378,0.393513513513513
"248","AR Adams (NZ)",18,3,0,3,12,0,12,0.666666666666667,0,0.666666666666667
"249","AR Bhat (INDIA)",6,0,0,0,0,0,0,0,0,0
"250","AR Border (AUS)",11220,1167,28,1195,4668,168,4836,0.416042780748663,0.0149732620320856,0.431016042780749
"251","AR Butcher (ENG)",34,3,0,3,12,0,12,0.352941176470588,0,0.352941176470588
"252","AR Caddick (ENG)",861,102,7,109,408,42,450,0.473867595818815,0.0487804878048781,0.522648083623693
"253","AR Dell (AUS)",6,0,0,0,0,0,0,0,0,0
"254","AR Gover (ENG)",2,0,0,0,0,0,0,0,0,0
"255","AR Kapoor (INDIA)",97,8,2,10,32,12,44,0.329896907216495,0.123711340206186,0.45360824742268
"256","AR Lewis (ENG)",457,51,1,52,204,6,210,0.446389496717724,0.0131291028446389,0.459518599562363
"257","AR MacGibbon (NZ)",814,72,4,76,288,24,312,0.353808353808354,0.0294840294840295,0.383292383292383
"258","AR Morris (AUS)",3533,301,10,311,1204,60,1264,0.340786866685536,0.0169827342202095,0.357769600905746
"259","AR Richards (SA)",6,0,0,0,0,0,0,0,0,0
"260","AR Whittall (ZIM)",114,12,0,12,48,0,48,0.421052631578947,0,0.421052631578947
"261","ARA Murray (SA)",289,23,0,23,92,0,92,0.318339100346021,0,0.318339100346021
"262","ARC Fraser (ENG)",388,33,2,35,132,12,144,0.34020618556701,0.0309278350515464,0.371134020618557
"263","Arif Butt (PAK)",59,0,0,0,0,0,0,0,0,0
"264","ARS Silva (SL)",461,42,2,44,168,12,180,0.364425162689805,0.0260303687635575,0.390455531453362
"265","Arshad Ayub (INDIA)",257,25,0,25,100,0,100,0.389105058365759,0,0.389105058365759
"266","Arshad Khan (PAK)",31,3,0,3,12,0,12,0.387096774193548,0,0.387096774193548
"267","AS Jaggernauth (WI)",0,0,0,0,0,0,0,NA,NA,NA
"268","AS Joseph (WI)",41,6,0,6,24,0,24,0.585365853658537,0,0.585365853658537
"269","AS Kennedy (ENG)",93,0,0,0,0,0,0,0,0,0
"270","AS Wassan (INDIA)",94,9,0,9,36,0,36,0.382978723404255,0,0.382978723404255
"271","ASA Perera (SL)",77,12,1,13,48,6,54,0.623376623376623,0.0779220779220779,0.701298701298701
"272","Asad Shafiq (PAK)",3768,411,25,436,1644,150,1794,0.436305732484076,0.0398089171974522,0.476114649681529
"273","Asghar Afghan (AFG)",36,6,1,7,24,6,30,0.666666666666667,0.166666666666667,0.833333333333333
"274","Ashfaq Ahmed (PAK)",1,0,0,0,0,0,0,0,0,0
"275","Ashraf Ali (PAK)",229,21,0,21,84,0,84,0.366812227074236,0,0.366812227074236
"276","Asif Iqbal (PAK)",3575,350,17,367,1400,102,1502,0.391608391608392,0.0285314685314685,0.42013986013986
"277","Asif Masood (PAK)",93,4,1,5,16,6,22,0.172043010752688,0.0645161290322581,0.236559139784946
"278","Asif Mujtaba (PAK)",928,107,0,107,428,0,428,0.461206896551724,0,0.461206896551724
"279","Asim Kamal (PAK)",717,104,6,110,416,36,452,0.580195258019526,0.0502092050209205,0.630404463040446
"280","ASM Oakman (ENG)",14,1,0,1,4,0,4,0.285714285714286,0,0.285714285714286
"281","AT Roberts (WI)",28,0,0,0,0,0,0,0,0,0
"282","Ata-ur-Rehman (PAK)",76,8,1,9,32,6,38,0.421052631578947,0.0789473684210526,0.5
"283","Atif Rauf (PAK)",25,2,0,2,8,0,8,0.32,0,0.32
"284","Atiq-uz-Zaman (PAK)",26,3,0,3,12,0,12,0.461538461538462,0,0.461538461538462
"285","ATW Grout (AUS)",890,51,0,51,204,0,204,0.229213483146067,0,0.229213483146067
"286","AU Rashid (ENG)",383,45,1,46,180,6,186,0.469973890339426,0.0156657963446475,0.485639686684073
"287","AV Bedser (ENG)",714,49,6,55,196,36,232,0.274509803921569,0.0504201680672269,0.324929971988796
"288","AV Mankad (INDIA)",991,63,0,63,252,0,252,0.254288597376387,0,0.254288597376387
"289","AW Briscoe (SA)",33,0,0,0,0,0,0,0,0,0
"290","AW Carr (ENG)",237,0,0,0,0,0,0,0,0,0
"291","AW Greig (ENG)",3599,437,19,456,1748,114,1862,0.485690469574882,0.0316754654070575,0.517365934981939
"292","AW Mold (ENG)",0,0,0,0,0,0,0,NA,NA,NA
"293","AW Nourse (SA)",2230,94,0,94,376,0,376,0.168609865470852,0,0.168609865470852
"294","AW Palm (SA)",15,0,0,0,0,0,0,0,0,0
"295","AW Powell (SA)",16,0,0,0,0,0,0,0,0,0
"296","AW Roberts (NZ)",248,6,0,6,24,0,24,0.0967741935483871,0,0.0967741935483871
"297","AW Seccull (SA)",23,0,0,0,0,0,0,0,0,0
"298","AW Wellard (ENG)",47,7,1,8,28,6,34,0.595744680851064,0.127659574468085,0.723404255319149
"299","AW White (WI)",71,0,1,1,0,6,6,0,0.0845070422535211,0.0845070422535211
"300","Azam Khan (PAK)",14,1,0,1,4,0,4,0.285714285714286,0,0.285714285714286
"301","Azeem Hafeez (PAK)",134,8,0,8,32,0,32,0.238805970149254,0,0.238805970149254
"302","Azhar Ali (PAK)",5202,480,15,495,1920,90,2010,0.369088811995386,0.0173010380622837,0.38638985005767
"303","Azhar Khan (PAK)",14,3,0,3,12,0,12,0.857142857142857,0,0.857142857142857
"304","Azhar Mahmood (PAK)",900,113,5,118,452,30,482,0.502222222222222,0.0333333333333333,0.535555555555556
"305","Azmat Rana (PAK)",49,8,0,8,32,0,32,0.653061224489796,0,0.653061224489796
"306","B Andrews (NZ)",22,4,0,4,16,0,16,0.727272727272727,0,0.727272727272727
"307","B Arun (INDIA)",4,0,0,0,0,0,0,0,0,0
"308","B Casson (AUS)",10,1,0,1,4,0,4,0.4,0,0.4
"309","B Dooland (AUS)",76,4,0,4,16,0,16,0.210526315789474,0,0.210526315789474
"310","B Kumar (INDIA)",552,77,1,78,308,6,314,0.557971014492754,0.0108695652173913,0.568840579710145
"311","B Lee (AUS)",1451,182,18,200,728,108,836,0.501722949689869,0.0744314266023432,0.576154376292212
"312","B Mitchell (SA)",3471,103,1,104,412,6,418,0.11869778161913,0.0017286084701815,0.120426390089311
"313","B Muzarabani (ZIM)",14,2,1,3,8,6,14,0.571428571428571,0.428571428571429,1
"314","B Reddy (INDIA)",38,6,0,6,24,0,24,0.631578947368421,0,0.631578947368421
"315","B Sutcliffe (NZ)",2727,207,16,223,828,96,924,0.303630363036304,0.0352035203520352,0.338833883388339
"316","B Warnapura (SL)",96,11,0,11,44,0,44,0.458333333333333,0,0.458333333333333
"317","B Wood (ENG)",454,64,0,64,256,0,256,0.563876651982379,0,0.563876651982379
"318","B Yardley (AUS)",978,114,5,119,456,30,486,0.466257668711656,0.0306748466257669,0.496932515337423
"319","B Yograj Singh (INDIA)",10,1,0,1,4,0,4,0.4,0,0.4
"320","BA Barnett (AUS)",195,25,0,25,100,0,100,0.512820512820513,0,0.512820512820513
"321","BA Bolton (NZ)",59,3,0,3,12,0,12,0.203389830508475,0,0.203389830508475
"322","BA Davis (WI)",245,0,0,0,0,0,0,0,0,0
"323","BA Edgar (NZ)",1958,177,0,177,708,0,708,0.361593462717058,0,0.361593462717058
"324","BA Murphy (ZIM)",123,17,0,17,68,0,68,0.552845528455285,0,0.552845528455285
"325","BA Parchment (WI)",55,5,0,5,20,0,20,0.363636363636364,0,0.363636363636364
"326","BA Pocock (NZ)",665,59,0,59,236,0,236,0.354887218045113,0,0.354887218045113
"327","BA Reid (AUS)",93,7,0,7,28,0,28,0.301075268817204,0,0.301075268817204
"328","BA Richards (SA)",508,70,5,75,280,30,310,0.551181102362205,0.0590551181102362,0.610236220472441
"329","BA Stokes (ENG)",2742,360,40,400,1440,240,1680,0.525164113785558,0.087527352297593,0.612691466083151
"330","BA Williams (AUS)",23,0,1,1,0,6,6,0,0.260869565217391,0.260869565217391
"331","BA Young (NZ)",1988,226,1,227,904,6,910,0.454728370221328,0.00301810865191147,0.457746478873239
"332","Babar Azam (PAK)",616,66,1,67,264,6,270,0.428571428571429,0.00974025974025974,0.438311688311688
"333","BAF Grieve (ENG)",40,6,0,6,24,0,24,0.6,0,0.6
"334","BAG Murray (NZ)",598,49,2,51,196,12,208,0.327759197324415,0.020066889632107,0.347826086956522
"335","Basit Ali (PAK)",858,91,7,98,364,42,406,0.424242424242424,0.048951048951049,0.473193473193473
"336","BAW Mendis (SL)",213,25,1,26,100,6,106,0.469483568075117,0.028169014084507,0.497652582159624
"337","Bazid Khan (PAK)",32,5,0,5,20,0,20,0.625,0,0.625
"338","BB Chari (ZIM)",141,15,3,18,60,18,78,0.425531914893617,0.127659574468085,0.553191489361702
"339","BB Cooper (AUS)",18,0,0,0,0,0,0,0,0,0
"340","BB McCullum (NZ)",6453,776,107,883,3104,642,3746,0.481016581434991,0.099488609948861,0.580505191383852
"341","BBM Gaskin (WI)",17,0,0,0,0,0,0,0,0,0
"342","BC Booth (AUS)",1773,138,3,141,552,18,570,0.311336717428088,0.0101522842639594,0.321489001692047
"343","BC Broad (ENG)",1661,173,1,174,692,6,698,0.416616496086695,0.00361228175797712,0.420228777844672
"344","BC Francis (AUS)",52,4,0,4,16,0,16,0.307692307692308,0,0.307692307692308
"345","BC Hollioake (ENG)",44,6,0,6,24,0,24,0.545454545454545,0,0.545454545454545
"346","BC Lara (ICC)",41,8,0,8,32,0,32,0.780487804878049,0,0.780487804878049
"347","BC Lara (WI)",11912,1551,88,1639,6204,528,6732,0.520819341840161,0.0443250503693754,0.565144392209537
"348","BC Rose (ENG)",358,38,0,38,152,0,152,0.424581005586592,0,0.424581005586592
"349","BC Strang (ZIM)",465,54,2,56,216,12,228,0.464516129032258,0.0258064516129032,0.490322580645161
"350","BD Julien (WI)",866,78,7,85,312,42,354,0.360277136258661,0.0484988452655889,0.408775981524249
"351","BD Milburn (NZ)",8,0,0,0,0,0,0,0,0,0
"352","BD Morrison (NZ)",10,2,0,2,8,0,8,0.8,0,0.8
"353","BE Congdon (NZ)",3448,267,12,279,1068,72,1140,0.309744779582367,0.0208816705336427,0.330626450116009
"354","BE McGain (AUS)",2,0,0,0,0,0,0,0,0,0
"355","BF Butcher (WI)",3104,266,6,272,1064,36,1100,0.342783505154639,0.0115979381443299,0.354381443298969
"356","BF Hastings (NZ)",1510,134,3,137,536,18,554,0.354966887417219,0.0119205298013245,0.366887417218543
"357","BG Rogers (ZIM)",90,14,0,14,56,0,56,0.622222222222222,0,0.622222222222222
"358","BGK Walker (NZ)",118,10,0,10,40,0,40,0.338983050847458,0,0.338983050847458
"359","BH Pairaudeau (WI)",454,7,0,7,28,0,28,0.0616740088105727,0,0.0616740088105727
"360","BH Valentine (ENG)",454,35,3,38,140,18,158,0.308370044052863,0.039647577092511,0.348017621145374
"361","Bilawal Bhatti (PAK)",70,9,1,10,36,6,42,0.514285714285714,0.0857142857142857,0.6
"362","BJ Arnel (NZ)",45,5,0,5,20,0,20,0.444444444444444,0,0.444444444444444
"363","BJ Bess (WI)",11,1,1,2,4,6,10,0.363636363636364,0.545454545454545,0.909090909090909
"364","BJ Haddin (AUS)",3266,363,54,417,1452,324,1776,0.444580526638089,0.099203919167177,0.543784445805266
"365","BJ Hodge (AUS)",503,60,1,61,240,6,246,0.47713717693837,0.0119284294234592,0.489065606361829
"366","BJ Sealey (WI)",41,0,0,0,0,0,0,0,0,0
"367","BJ Watling (NZ)",2837,335,7,342,1340,42,1382,0.472329925978146,0.0148043708142404,0.487134296792386
"368","BJT Bosanquet (ENG)",147,5,0,5,20,0,20,0.136054421768707,0,0.136054421768707
"369","BK Kunderan (INDIA)",981,139,2,141,556,12,568,0.566768603465851,0.0122324159021407,0.579001019367992
"370","BK Shepherd (AUS)",502,47,1,48,188,6,194,0.374501992031873,0.0119521912350598,0.386454183266932
"371","BKG Mendis (SL)",2060,257,21,278,1028,126,1154,0.499029126213592,0.0611650485436893,0.560194174757282
"372","BKV Prasad (INDIA)",203,11,0,11,44,0,44,0.216748768472906,0,0.216748768472906
"373","BL Cairns (NZ)",928,80,28,108,320,168,488,0.344827586206897,0.181034482758621,0.525862068965517
"374","BL D'Oliveira (ENG)",2484,298,14,312,1192,84,1276,0.479871175523349,0.0338164251207729,0.513687600644122
"375","BL Irvine (SA)",353,33,6,39,132,36,168,0.373937677053824,0.101983002832861,0.475920679886686
"376","BM Duckett (ENG)",110,13,2,15,52,12,64,0.472727272727273,0.109090909090909,0.581818181818182
"377","BM Laird (AUS)",1341,94,0,94,376,0,376,0.280387770320656,0,0.280387770320656
"378","BM McMillan (SA)",1968,206,11,217,824,66,890,0.41869918699187,0.0335365853658537,0.452235772357724
"379","BN French (ENG)",308,37,1,38,148,6,154,0.480519480519481,0.0194805194805195,0.5
"380","BN Jarman (AUS)",400,40,2,42,160,12,172,0.4,0.03,0.43
"381","BN Schultz (SA)",9,1,0,1,4,0,4,0.444444444444444,0,0.444444444444444
"382","BP Bracewell (NZ)",24,3,0,3,12,0,12,0.5,0,0.5
"383","BP Gupte (INDIA)",28,2,0,2,8,0,8,0.285714285714286,0,0.285714285714286
"384","BP Julian (AUS)",128,14,1,15,56,6,62,0.4375,0.046875,0.484375
"385","BP Martin (NZ)",74,14,0,14,56,0,56,0.756756756756757,0,0.756756756756757
"386","BP Nash (WI)",1103,130,3,133,520,18,538,0.471441523118767,0.0163191296464189,0.487760652765186
"387","BP Patel (INDIA)",972,97,7,104,388,42,430,0.39917695473251,0.0432098765432099,0.44238683127572
"388","BP Patterson (WI)",145,18,0,18,72,0,72,0.496551724137931,0,0.496551724137931
"389","BR Hartland (NZ)",303,35,0,35,140,0,140,0.462046204620462,0,0.462046204620462
"390","BR Jurangpathy (SL)",1,0,0,0,0,0,0,0,0,0
"391","BR Knight (ENG)",812,94,3,97,376,18,394,0.463054187192118,0.0221674876847291,0.485221674876847
"392","BR Taylor (NZ)",898,98,13,111,392,78,470,0.43652561247216,0.0868596881959911,0.523385300668151
"393","BRM Taylor (ZIM)",1594,162,15,177,648,90,738,0.406524466750314,0.0564617314930991,0.462986198243413
"394","BS Bedi (INDIA)",656,51,3,54,204,18,222,0.310975609756098,0.0274390243902439,0.338414634146341
"395","BS Chandrasekhar (INDIA)",167,12,0,12,48,0,48,0.287425149700599,0,0.287425149700599
"396","BS Sandhu (INDIA)",214,17,3,20,68,18,86,0.317757009345794,0.0841121495327103,0.401869158878505
"397","BT Watambwa (ZIM)",11,0,0,0,0,0,0,0,0,0
"398","BV Vitori (ZIM)",52,7,1,8,28,6,34,0.538461538461538,0.115384615384615,0.653846153846154
"399","BW Hilfenhaus (AUS)",355,48,5,53,192,30,222,0.540845070422535,0.0845070422535211,0.625352112676056
"400","BW Luckhurst (ENG)",1298,136,1,137,544,6,550,0.419106317411402,0.00462249614791988,0.423728813559322
"401","BW Sinclair (NZ)",1148,99,0,99,396,0,396,0.344947735191638,0,0.344947735191638
"402","BW Yuile (NZ)",481,36,0,36,144,0,144,0.299376299376299,0,0.299376299376299
"403","C Bannerman (AUS)",239,19,1,20,76,6,82,0.317991631799163,0.0251046025104603,0.343096234309623
"404","C Blythe (ENG)",183,12,0,12,48,0,48,0.262295081967213,0,0.262295081967213
"405","C Burke (NZ)",4,0,0,0,0,0,0,0,0,0
"406","C Cook (ENG)",4,0,0,0,0,0,0,0,0,0
"407","C de Grandhomme (NZ)",537,59,16,75,236,96,332,0.439478584729981,0.17877094972067,0.618249534450652
"408","C Gladwin (ENG)",170,1,2,3,4,12,16,0.0235294117647059,0.0705882352941176,0.0941176470588235
"409","C Hallows (ENG)",42,1,0,1,4,0,4,0.0952380952380952,0,0.0952380952380952
"410","C Heseltine (ENG)",18,0,0,0,0,0,0,0,0,0
"411","C Hill (AUS)",3416,248,1,249,992,6,998,0.2903981264637,0.00175644028103044,0.292154566744731
"412","C Kelleway (AUS)",1418,88,0,88,352,0,352,0.248236953455571,0,0.248236953455571
"413","C Milburn (ENG)",654,91,11,102,364,66,430,0.556574923547401,0.100917431192661,0.657492354740061
"414","C Munro (NZ)",15,3,0,3,12,0,12,0.8,0,0.8
"415","C Newberry (SA)",62,0,0,0,0,0,0,0,0,0
"416","C Overton (ENG)",98,13,1,14,52,6,58,0.530612244897959,0.0612244897959184,0.591836734693878
"417","C Pringle (NZ)",175,23,3,26,92,18,110,0.525714285714286,0.102857142857143,0.628571428571429
"418","C Ramaswami (INDIA)",170,0,1,1,0,6,6,0,0.0352941176470588,0.0352941176470588
"419","C Sharma (INDIA)",396,32,1,33,128,6,134,0.323232323232323,0.0151515151515152,0.338383838383838
"420","C Washbrook (ENG)",2569,160,8,168,640,48,688,0.249124172829895,0.0186843129622421,0.267808485792137
"421","C Wesley (SA)",49,0,0,0,0,0,0,0,0,0
"422","C White (ENG)",1052,119,12,131,476,72,548,0.452471482889734,0.0684410646387833,0.520912547528517
"423","CA Absolom (ENG)",58,5,0,5,20,0,20,0.344827586206897,0,0.344827586206897
"424","CA Best (WI)",342,39,2,41,156,12,168,0.456140350877193,0.0350877192982456,0.491228070175439
"425","CA Davis (WI)",1301,93,1,94,372,6,378,0.285933897002306,0.00461183704842429,0.29054573405073
"426","CA McWatt (WI)",202,0,0,0,0,0,0,0,0,0
"427","CA Merry (WI)",34,0,0,0,0,0,0,0,0,0
"428","CA Milton (ENG)",204,21,1,22,84,6,90,0.411764705882353,0.0294117647058824,0.441176470588235
"429","CA Pujara (INDIA)",4772,567,9,576,2268,54,2322,0.475272422464376,0.0113160100586756,0.486588432523051
"430","CA Roach (WI)",952,69,5,74,276,30,306,0.289915966386555,0.0315126050420168,0.321428571428571
"431","CA Smith (ENG)",3,0,0,0,0,0,0,0,0,0
"432","CA Walsh (WI)",936,77,19,96,308,114,422,0.329059829059829,0.121794871794872,0.450854700854701
"433","CA Wiles (WI)",2,0,0,0,0,0,0,0,0,0
"434","CAG Russell (ENG)",910,50,1,51,200,6,206,0.21978021978022,0.00659340659340659,0.226373626373626
"435","CAK Rajitha (SL)",4,0,0,0,0,0,0,0,0,0
"436","CAK Walton (WI)",13,0,1,1,0,6,6,0,0.461538461538462,0.461538461538462
"437","CAR Duckworth (SA)",28,2,0,2,8,0,8,0.285714285714286,0,0.285714285714286
"438","CB Clarke (WI)",3,0,0,0,0,0,0,0,0,0
"439","CB Fry (ENG)",1223,45,0,45,180,0,180,0.147179067865904,0,0.147179067865904
"440","CB Jennings (AUS)",107,0,0,0,0,0,0,0,0,0
"441","CB Lambert (WI)",284,34,2,36,136,12,148,0.47887323943662,0.0422535211267606,0.52112676056338
"442","CB Llewellyn (SA)",548,11,0,11,44,0,44,0.0802919708029197,0,0.0802919708029197
"443","CB Mpofu (ZIM)",105,7,5,12,28,30,58,0.266666666666667,0.285714285714286,0.552380952380952
"444","CB van Ryneveld (SA)",724,25,0,25,100,0,100,0.138121546961326,0,0.138121546961326
"445","CB Wishart (ZIM)",1098,126,12,138,504,72,576,0.459016393442623,0.0655737704918033,0.524590163934426
"446","CBRLS Kumara (SL)",44,8,0,8,32,0,32,0.727272727272727,0,0.727272727272727
"447","CC Depeiaza (WI)",187,16,0,16,64,0,64,0.342245989304813,0,0.342245989304813
"448","CC Griffith (WI)",530,46,4,50,184,24,208,0.347169811320755,0.0452830188679245,0.392452830188679
"449","CC Hunte (WI)",3245,211,3,214,844,18,862,0.260092449922958,0.00554699537750385,0.265639445300462
"450","CC Lewis (ENG)",1105,137,6,143,548,36,584,0.495927601809955,0.032579185520362,0.528506787330317
"451","CC McDonald (AUS)",3107,166,3,169,664,18,682,0.213710975217251,0.00579336981010621,0.219504345027358
"452","CC Passailaigue (WI)",46,6,0,6,24,0,24,0.521739130434783,0,0.521739130434783
"453","CD Collymore (WI)",197,19,0,19,76,0,76,0.385786802030457,0,0.385786802030457
"454","CD Cumming (NZ)",441,56,2,58,224,12,236,0.507936507936508,0.0272108843537415,0.535147392290249
"455","CD Dixon (SA)",0,0,0,0,0,0,0,NA,NA,NA
"456","CD Gopinath (INDIA)",242,0,0,0,0,0,0,0,0,0
"457","CD Matthews (AUS)",54,7,0,7,28,0,28,0.518518518518518,0,0.518518518518518
"458","CD McMillan (NZ)",3116,367,54,421,1468,324,1792,0.471116816431322,0.10397946084724,0.575096277278562
"459","CD Watson (WI)",12,0,0,0,0,0,0,0,0,0
"460","CDUS Weerasinghe (SL)",3,0,0,0,0,0,0,0,0,0
"461","CE Cuffy (WI)",58,5,0,5,20,0,20,0.344827586206897,0,0.344827586206897
"462","CE Eksteen (SA)",91,6,0,6,24,0,24,0.263736263736264,0,0.263736263736264
"463","CE Finlason (SA)",6,1,0,1,4,0,4,0.666666666666667,0,0.666666666666667
"464","CE Floquet (SA)",12,0,0,0,0,0,0,0,0,0
"465","CE McLeod (AUS)",573,28,0,28,112,0,112,0.195462478184991,0,0.195462478184991
"466","CE Pellew (AUS)",484,50,0,50,200,0,200,0.413223140495868,0,0.413223140495868
"467","CEH Croft (WI)",158,8,1,9,32,6,38,0.20253164556962,0.0379746835443038,0.240506329113924
"468","CEJ Guest (AUS)",11,1,0,1,4,0,4,0.363636363636364,0,0.363636363636364
"469","CEL Ambrose (WI)",1439,172,12,184,688,72,760,0.478109798471161,0.0500347463516331,0.528144544822794
"470","CEL Jones (WI)",63,0,0,0,0,0,0,0,0,0
"471","CEL Stuart (WI)",24,3,0,3,12,0,12,0.5,0,0.5
"472","CEM Wilson (ENG)",42,0,0,0,0,0,0,0,0,0
"473","CEW Silverwood (ENG)",29,3,0,3,12,0,12,0.413793103448276,0,0.413793103448276
"474","CF Walters (ENG)",784,8,0,8,32,0,32,0.0408163265306122,0,0.0408163265306122
"475","CFH Leslie (ENG)",106,6,0,6,24,0,24,0.226415094339623,0,0.226415094339623
"476","CFH Prince (SA)",6,0,0,0,0,0,0,0,0,0
"477","CFK van Wyk (NZ)",341,41,0,41,164,0,164,0.480938416422287,0,0.480938416422287
"478","CFW Allcott (NZ)",113,0,0,0,0,0,0,0,0,0
"479","CFW Hime (SA)",8,0,0,0,0,0,0,0,0,0
"480","CG Borde (INDIA)",3061,295,1,296,1180,6,1186,0.385494936295328,0.00196014374387455,0.387455080039203
"481","CG Butts (WI)",108,10,3,13,40,18,58,0.37037037037037,0.166666666666667,0.537037037037037
"482","CG Fichardt (SA)",15,0,0,0,0,0,0,0,0,0
"483","CG Greenidge (WI)",7604,890,67,957,3560,402,3962,0.468174644923724,0.0528669121514992,0.521041557075224
"484","CG Halse (SA)",30,6,0,6,24,0,24,0.8,0,0.8
"485","CG Macartney (AUS)",2139,199,3,202,796,18,814,0.372136512388967,0.00841514726507714,0.380551659654044
"486","CG Rackemann (AUS)",53,3,0,3,12,0,12,0.226415094339623,0,0.226415094339623
"487","CG Rowe (NZ)",0,0,0,0,0,0,0,NA,NA,NA
"488","CGD Burger (SA)",62,0,1,1,0,6,6,0,0.0967741935483871,0.0967741935483871
"489","CH Gayle (WI)",7214,1046,98,1144,4184,588,4772,0.579983365677849,0.0815081785417244,0.661491544219573
"490","CH Lloyd (WI)",7515,758,70,828,3032,420,3452,0.403459747172322,0.0558882235528942,0.459347970725216
"491","CH Mills (SA)",25,0,0,0,0,0,0,0,0,0
"492","CH Morris (SA)",173,25,0,25,100,0,100,0.578034682080925,0,0.578034682080925
"493","CH Palmer (ENG)",22,0,0,0,0,0,0,0,0,0
"494","CH Parkin (ENG)",152,15,1,16,60,6,66,0.394736842105263,0.0394736842105263,0.434210526315789
"495","CH Vintcent (SA)",26,2,0,2,8,0,8,0.307692307692308,0,0.307692307692308
"496","CI Dunusinghe (SL)",160,15,1,16,60,6,66,0.375,0.0375,0.4125
"497","CIJ Smith (ENG)",102,0,5,5,0,30,30,0,0.294117647058824,0.294117647058824
"498","CJ Adams (ENG)",104,13,0,13,52,0,52,0.5,0,0.5
"499","CJ Anderson (NZ)",683,94,14,108,376,84,460,0.550512445095168,0.12298682284041,0.673499267935578
"500","CJ Barnett (ENG)",1098,88,5,93,352,30,382,0.320582877959927,0.0273224043715847,0.347905282331512
"501","CJ Chibhabha (ZIM)",124,18,0,18,72,0,72,0.580645161290323,0,0.580645161290323
"502","CJ Drum (NZ)",10,1,0,1,4,0,4,0.4,0,0.4
"503","CJ Eady (AUS)",20,0,0,0,0,0,0,0,0,0
"504","CJ Ferguson (AUS)",4,0,0,0,0,0,0,0,0,0
"505","CJ Jordan (ENG)",180,24,1,25,96,6,102,0.533333333333333,0.0333333333333333,0.566666666666667
"506","CJ McDermott (AUS)",940,90,6,96,360,36,396,0.382978723404255,0.0382978723404255,0.421276595744681
"507","CJ McKay (AUS)",10,1,0,1,4,0,4,0.4,0,0.4
"508","CJ Poole (ENG)",161,0,0,0,0,0,0,0,0,0
"509","CJ Richards (ENG)",331,36,0,36,144,0,144,0.435045317220544,0,0.435045317220544
"510","CJ Sayers (AUS)",0,0,0,0,0,0,0,NA,NA,NA
"511","CJ Tavare (ENG)",1755,175,0,175,700,0,700,0.398860398860399,0,0.398860398860399
"512","CJE Smith (SA)",106,0,1,1,0,6,6,0,0.0566037735849057,0.0566037735849057
"513","CJL Rogers (AUS)",2015,268,1,269,1072,6,1078,0.532009925558313,0.00297766749379653,0.534987593052109
"514","CK Coventry (ZIM)",88,14,1,15,56,6,62,0.636363636363636,0.0681818181818182,0.704545454545455
"515","CK Kapugedera (SL)",418,48,7,55,192,42,234,0.45933014354067,0.100478468899522,0.559808612440191
"516","CK Langeveldt (SA)",16,3,0,3,12,0,12,0.75,0,0.75
"517","CK Nayudu (INDIA)",350,0,1,1,0,6,6,0,0.0171428571428571,0.0171428571428571
"518","CK Singh (WI)",11,0,0,0,0,0,0,0,0,0
"519","CKB Kulasekara (SL)",22,2,0,2,8,0,8,0.363636363636364,0,0.363636363636364
"520","CL Badcock (AUS)",160,18,0,18,72,0,72,0.45,0,0.45
"521","CL Cairns (NZ)",3320,365,87,452,1460,522,1982,0.439759036144578,0.157228915662651,0.596987951807229
"522","CL Hooper (WI)",5762,633,63,696,2532,378,2910,0.439430753210691,0.0656022214508851,0.505032974661576
"523","CL Johnson (SA)",10,0,0,0,0,0,0,0,0,0
"524","CL King (WI)",418,48,5,53,192,30,222,0.45933014354067,0.0717703349282297,0.5311004784689
"525","CL McCool (AUS)",459,30,0,30,120,0,120,0.261437908496732,0,0.261437908496732
"526","CL Smith (ENG)",392,44,0,44,176,0,176,0.448979591836735,0,0.448979591836735
"527","CL Townsend (ENG)",51,0,0,0,0,0,0,0,0,0
"528","CL Vincent (SA)",526,20,8,28,80,48,128,0.152091254752852,0.091254752851711,0.243346007604563
"529","CL Walcott (WI)",3798,247,11,258,988,66,1054,0.26013691416535,0.0173775671406003,0.277514481305951
"530","CL White (AUS)",146,15,1,16,60,6,66,0.410958904109589,0.0410958904109589,0.452054794520548
"531","CM Christiani (WI)",98,0,0,0,0,0,0,0,0,0
"532","CM Francois (SA)",252,0,0,0,0,0,0,0,0,0
"533","CM Kuggeleijn (NZ)",7,1,0,1,4,0,4,0.571428571428571,0,0.571428571428571
"534","CM Old (ENG)",845,103,8,111,412,48,460,0.487573964497041,0.0568047337278106,0.544378698224852
"535","CM Spearman (NZ)",922,115,4,119,460,24,484,0.498915401301518,0.0260303687635575,0.524945770065076
"536","CMH Hathorn (SA)",325,22,0,22,88,0,88,0.270769230769231,0,0.270769230769231
"537","CMW Read (ENG)",360,36,4,40,144,24,168,0.4,0.0666666666666667,0.466666666666667
"538","CN Evans (ZIM)",52,8,0,8,32,0,32,0.615384615384615,0,0.615384615384615
"539","CN Frank (SA)",236,20,0,20,80,0,80,0.338983050847458,0,0.338983050847458
"540","CN McCarthy (SA)",28,0,0,0,0,0,0,0,0,0
"541","CO Browne (WI)",387,45,6,51,180,36,216,0.465116279069767,0.0930232558139535,0.558139534883721
"542","COC Pearse (SA)",55,8,0,8,32,0,32,0.581818181818182,0,0.581818181818182
"543","CP Buckenham (ENG)",43,0,0,0,0,0,0,0,0,0
"544","CP Carter (SA)",177,3,1,4,12,6,18,0.0677966101694915,0.0338983050847458,0.101694915254237
"545","CP McGahey (ENG)",38,0,0,0,0,0,0,0,0,0
"546","CP Mead (ENG)",1185,38,0,38,152,0,152,0.128270042194093,0,0.128270042194093
"547","CP Schofield (ENG)",67,8,0,8,32,0,32,0.477611940298507,0,0.477611940298507
"548","CP Senanayake (SL)",97,14,0,14,56,0,56,0.577319587628866,0,0.577319587628866
"549","CPH Ramanayake (SL)",143,13,0,13,52,0,52,0.363636363636364,0,0.363636363636364
"550","CPS Chauhan (INDIA)",2084,205,1,206,820,6,826,0.393474088291747,0.00287907869481766,0.396353166986564
"551","CR Brathwaite (WI)",181,12,7,19,48,42,90,0.265193370165746,0.232044198895028,0.497237569060773
"552","CR Browne (WI)",176,0,2,2,0,12,12,0,0.0681818181818182,0.0681818181818182
"553","CR Ervine (ZIM)",941,113,6,119,452,36,488,0.480340063761955,0.0382571732199787,0.518597236981934
"554","CR Matthews (SA)",348,47,2,49,188,12,200,0.540229885057471,0.0344827586206897,0.574712643678161
"555","CR Miller (AUS)",174,9,8,17,36,48,84,0.206896551724138,0.275862068965517,0.482758620689655
"556","CR Rangachari (INDIA)",8,0,0,0,0,0,0,0,0,0
"557","CR Woakes (ENG)",1012,132,1,133,528,6,534,0.521739130434783,0.00592885375494071,0.527667984189723
"558","CRD Fernando (SL)",249,30,1,31,120,6,126,0.481927710843373,0.0240963855421687,0.506024096385542
"559","CS Baugh (WI)",610,71,4,75,284,24,308,0.465573770491803,0.039344262295082,0.504918032786885
"560","CS Cowdrey (ENG)",101,9,2,11,36,12,48,0.356435643564356,0.118811881188119,0.475247524752475
"561","CS Dempster (NZ)",723,28,1,29,112,6,118,0.154910096818811,0.00829875518672199,0.163208852005533
"562","CS Marriott (ENG)",0,0,0,0,0,0,0,NA,NA,NA
"563","CS Martin (NZ)",123,15,0,15,60,0,60,0.48780487804878,0,0.48780487804878
"564","CS Nayudu (INDIA)",147,3,2,5,12,12,24,0.0816326530612245,0.0816326530612245,0.163265306122449
"565","CS Pandit (INDIA)",171,18,0,18,72,0,72,0.421052631578947,0,0.421052631578947
"566","CS Serjeant (AUS)",522,62,1,63,248,6,254,0.475095785440613,0.0114942528735632,0.486590038314176
"567","CS Wimble (SA)",0,0,0,0,0,0,0,NA,NA,NA
"568","CT Bancroft (AUS)",402,56,1,57,224,6,230,0.557213930348259,0.0149253731343284,0.572139303482587
"569","CT Mumba (ZIM)",14,1,0,1,4,0,4,0.285714285714286,0,0.285714285714286
"570","CT Patankar (INDIA)",14,0,0,0,0,0,0,0,0,0
"571","CT Radley (ENG)",481,43,0,43,172,0,172,0.357588357588358,0,0.357588357588358
"572","CT Sarwate (INDIA)",208,5,0,5,20,0,20,0.0961538461538462,0,0.0961538461538462
"573","CT Studd (ENG)",160,11,0,11,44,0,44,0.275,0,0.275
"574","CT Tremlett (ENG)",113,12,0,12,48,0,48,0.424778761061947,0,0.424778761061947
"575","CTB Turner (AUS)",323,12,0,12,48,0,48,0.148606811145511,0,0.148606811145511
"576","CV Gadkari (INDIA)",129,0,0,0,0,0,0,0,0,0
"577","CV Grimmett (AUS)",557,17,2,19,68,12,80,0.122082585278276,0.0215439856373429,0.143626570915619
"578","CV Wight (WI)",67,0,0,0,0,0,0,0,0,0
"579","CW Henderson (SA)",65,9,0,9,36,0,36,0.553846153846154,0,0.553846153846154
"580","CW Smith (WI)",222,31,1,32,124,6,130,0.558558558558559,0.027027027027027,0.585585585585586
"581","CW Wright (ENG)",125,0,0,0,0,0,0,0,0,0
"582","CWJ Athey (ENG)",919,93,0,93,372,0,372,0.404787812840044,0,0.404787812840044
"583","CWL Parker (ENG)",3,0,0,0,0,0,0,0,0,0
"584","CZ Harris (NZ)",777,87,2,89,348,12,360,0.447876447876448,0.0154440154440154,0.463320463320463
"585","D Bishoo (WI)",647,63,4,67,252,24,276,0.389489953632148,0.0370942812982998,0.426584234930448
"586","D Brookes (ENG)",17,0,0,0,0,0,0,0,0,0
"587","D Dasgupta (INDIA)",344,40,1,41,160,6,166,0.465116279069767,0.0174418604651163,0.482558139534884
"588","D Denton (ENG)",424,23,0,23,92,0,92,0.216981132075472,0,0.216981132075472
"589","D Elgar (SA)",3243,385,21,406,1540,126,1666,0.474868948504471,0.0388529139685476,0.513721862473019
"590","D Gamsy (SA)",39,2,0,2,8,0,8,0.205128205128205,0,0.205128205128205
"591","D Ganesh (INDIA)",25,1,0,1,4,0,4,0.16,0,0.16
"592","D Ganga (WI)",2160,284,2,286,1136,12,1148,0.525925925925926,0.00555555555555556,0.531481481481481
"593","D Gough (ENG)",855,102,9,111,408,54,462,0.47719298245614,0.0631578947368421,0.540350877192982
"594","D Hettiarachchi (SL)",0,0,0,0,0,0,0,NA,NA,NA
"595","D Kenyon (ENG)",192,10,0,10,40,0,40,0.208333333333333,0,0.208333333333333
"596","D Lloyd (ENG)",552,54,0,54,216,0,216,0.391304347826087,0,0.391304347826087
"597","D Mohammed (WI)",225,32,6,38,128,36,164,0.568888888888889,0.16,0.728888888888889
"598","D Olivier (SA)",7,1,0,1,4,0,4,0.571428571428571,0,0.571428571428571
"599","D Pretorius (SA)",22,4,0,4,16,0,16,0.727272727272727,0,0.727272727272727
"600","D Ramdin (WI)",2898,376,6,382,1504,36,1540,0.518978605935128,0.0124223602484472,0.531400966183575
"601","D Ramnarine (WI)",106,12,0,12,48,0,48,0.452830188679245,0,0.452830188679245
"602","D Ranatunga (SL)",87,4,0,4,16,0,16,0.183908045977011,0,0.183908045977011
"603","D Shackleton (ENG)",113,2,0,2,8,0,8,0.0707964601769911,0,0.0707964601769911
"604","D Smith (ENG)",128,0,0,0,0,0,0,0,0,0
"605","D Tallon (AUS)",394,24,0,24,96,0,96,0.243654822335025,0,0.243654822335025
"606","D Taylor (SA)",85,0,0,0,0,0,0,0,0,0
"607","D Williams (WI)",242,22,0,22,88,0,88,0.363636363636364,0,0.363636363636364
"608","D Wilson (ENG)",75,7,1,8,28,6,34,0.373333333333333,0.08,0.453333333333333
"609","DA Allen (ENG)",918,66,0,66,264,0,264,0.287581699346405,0,0.287581699346405
"610","DA Gunawardene (SL)",181,33,0,33,132,0,132,0.729281767955801,0,0.729281767955801
"611","DA Marillier (ZIM)",186,16,2,18,64,12,76,0.344086021505376,0.0645161290322581,0.408602150537634
"612","DA Murray (WI)",647,40,0,40,160,0,160,0.247295208655332,0,0.247295208655332
"613","DA Reeve (ENG)",124,8,0,8,32,0,32,0.258064516129032,0,0.258064516129032
"614","DA Renneberg (AUS)",22,1,0,1,4,0,4,0.181818181818182,0,0.181818181818182
"615","DA Sharpe (PAK)",134,0,0,0,0,0,0,0,0,0
"616","DA Stirling (NZ)",108,11,3,14,44,18,62,0.407407407407407,0.166666666666667,0.574074074074074
"617","DA Warner (AUS)",6363,765,55,820,3060,330,3390,0.480905233380481,0.0518623290900519,0.532767562470533
"618","DAJ Bracewell (NZ)",568,70,8,78,280,48,328,0.492957746478873,0.0845070422535211,0.577464788732394
"619","DAJ Holford (WI)",768,58,1,59,232,6,238,0.302083333333333,0.0078125,0.309895833333333
"620","DAN McRae (NZ)",8,0,0,0,0,0,0,0,0,0
"621","Danish Kaneria (PAK)",360,46,3,49,184,18,202,0.511111111111111,0.05,0.561111111111111
"622","DAR Moloney (NZ)",156,0,0,0,0,0,0,0,0,0
"623","DAS Gunaratne (SL)",455,50,1,51,200,6,206,0.43956043956044,0.0131868131868132,0.452747252747253
"624","DB Carr (ENG)",135,0,0,0,0,0,0,0,0,0
"625","DB Close (ENG)",887,88,4,92,352,24,376,0.39684329199549,0.0270574971815107,0.423900789177001
"626","DB Pithey (SA)",138,3,0,3,12,0,12,0.0869565217391304,0,0.0869565217391304
"627","DB Vengsarkar (INDIA)",6914,564,17,581,2256,102,2358,0.326294474978305,0.0147526757304021,0.341047150708707
"628","DBL Powell (WI)",407,50,4,54,200,24,224,0.491400491400491,0.058968058968059,0.55036855036855
"629","DBM Smith (AUS)",30,0,0,0,0,0,0,0,0,0
"630","DC Boon (AUS)",7422,826,2,828,3304,12,3316,0.445163028833199,0.00161681487469685,0.446779843707895
"631","DC Cleverley (NZ)",19,0,0,0,0,0,0,0,0,0
"632","DC Parkin (SA)",6,0,0,0,0,0,0,0,0,0
"633","DCH Townsend (ENG)",77,0,1,1,0,6,6,0,0.0779220779220779,0.0779220779220779
"634","DCS Compton (ENG)",5807,440,3,443,1760,18,1778,0.303082486654038,0.00309970724987085,0.306182193903909
"635","DD Beard (NZ)",101,0,1,1,0,6,6,0,0.0594059405940594,0.0594059405940594
"636","DD Blackie (AUS)",24,0,0,0,0,0,0,0,0,0
"637","DD Ebrahim (ZIM)",1225,145,0,145,580,0,580,0.473469387755102,0,0.473469387755102
"638","DD Hindlekar (INDIA)",71,0,0,0,0,0,0,0,0,0
"639","DD Parsana (INDIA)",1,0,0,0,0,0,0,0,0,0
"640","DD Taylor (NZ)",159,10,1,11,40,6,46,0.251572327044025,0.0377358490566038,0.289308176100629
"641","DE Bernard (WI)",202,18,3,21,72,18,90,0.356435643564356,0.0891089108910891,0.445544554455446
"642","DE Bollinger (AUS)",54,7,0,7,28,0,28,0.518518518518518,0,0.518518518518518
"643","DE Hoare (AUS)",35,2,0,2,8,0,8,0.228571428571429,0,0.228571428571429
"644","DE Malcolm (ENG)",236,31,7,38,124,42,166,0.525423728813559,0.177966101694915,0.703389830508475
"645","DEJ Ironside (SA)",37,0,0,0,0,0,0,0,0,0
"646","DEV Padgett (ENG)",51,5,0,5,20,0,20,0.392156862745098,0,0.392156862745098
"647","DF Whatmore (AUS)",293,36,0,36,144,0,144,0.491467576791809,0,0.491467576791809
"648","DG Bradman (AUS)",6996,681,6,687,2724,36,2760,0.389365351629503,0.00514579759862779,0.39451114922813
"649","DG Brownlie (NZ)",711,96,3,99,384,18,402,0.540084388185654,0.0253164556962025,0.565400843881857
"650","DG Cork (ENG)",864,111,4,115,444,24,468,0.513888888888889,0.0277777777777778,0.541666666666667
"651","DG Phadkar (INDIA)",1229,35,4,39,140,24,164,0.113913751017087,0.0195280716029292,0.133441822620016
"652","DG Sewell (NZ)",1,0,0,0,0,0,0,0,0,0
"653","DH Brain (ZIM)",115,17,0,17,68,0,68,0.591304347826087,0,0.591304347826087
"654","DI Gower (ENG)",8277,986,10,996,3944,60,4004,0.47650114775885,0.00724900326205147,0.483750151020901
"655","Dilawar Hussain (INDIA)",254,9,2,11,36,12,48,0.141732283464567,0.047244094488189,0.188976377952756
"656","DJ Bravo (WI)",2200,269,21,290,1076,126,1202,0.489090909090909,0.0572727272727273,0.546363636363636
"657","DJ Brown (ENG)",342,31,0,31,124,0,124,0.362573099415205,0,0.362573099415205
"658","DJ Capel (ENG)",374,34,1,35,136,6,142,0.363636363636364,0.0160427807486631,0.379679144385027
"659","DJ Colley (AUS)",84,9,0,9,36,0,36,0.428571428571429,0,0.428571428571429
"660","DJ Cullinan (SA)",4416,532,25,557,2128,150,2278,0.481884057971014,0.0339673913043478,0.515851449275362
"661","DJ Gandhi (INDIA)",204,27,1,28,108,6,114,0.529411764705882,0.0294117647058824,0.558823529411765
"662","DJ Insole (ENG)",408,25,0,25,100,0,100,0.245098039215686,0,0.245098039215686
"663","DJ Johnson (INDIA)",8,1,0,1,4,0,4,0.5,0,0.5
"664","DJ Knight (ENG)",54,3,0,3,12,0,12,0.222222222222222,0,0.222222222222222
"665","DJ Malan (ENG)",724,97,1,98,388,6,394,0.535911602209945,0.00828729281767956,0.544198895027624
"666","DJ McGlew (SA)",2440,154,2,156,616,12,628,0.252459016393443,0.00491803278688525,0.257377049180328
"667","DJ Meintjes (SA)",43,0,0,0,0,0,0,0,0,0
"668","DJ Murray (NZ)",303,34,0,34,136,0,136,0.448844884488449,0,0.448844884488449
"669","DJ Nash (NZ)",729,65,4,69,260,24,284,0.356652949245542,0.0329218106995885,0.38957475994513
"670","DJ Pagon (WI)",37,7,0,7,28,0,28,0.756756756756757,0,0.756756756756757
"671","DJ Pattinson (ENG)",21,3,0,3,12,0,12,0.571428571428571,0,0.571428571428571
"672","DJ Richardson (SA)",1359,144,2,146,576,12,588,0.423841059602649,0.00883002207505519,0.432671081677704
"673","DJ Sincock (AUS)",80,9,0,9,36,0,36,0.45,0,0.45
"674","DJ Terbrugge (SA)",16,0,0,0,0,0,0,0,0,0
"675","DJ Vilas (SA)",94,11,0,11,44,0,44,0.468085106382979,0,0.468085106382979
"676","DJ White (NZ)",31,3,0,3,12,0,12,0.387096774193548,0,0.387096774193548
"677","DJG Sammy (WI)",1323,157,34,191,628,204,832,0.474678760393046,0.154195011337868,0.628873771730915
"678","DK Gaekwad (INDIA)",350,9,0,9,36,0,36,0.102857142857143,0,0.102857142857143
"679","DK Lillee (AUS)",905,96,8,104,384,48,432,0.424309392265193,0.0530386740331492,0.477348066298343
"680","DK Liyanage (SL)",69,5,0,5,20,0,20,0.289855072463768,0,0.289855072463768
"681","DK Morrison (NZ)",379,35,1,36,140,6,146,0.369393139841689,0.0158311345646438,0.385224274406332
"682","DL Amiss (ENG)",3612,427,3,430,1708,18,1726,0.472868217054264,0.00498338870431894,0.477851605758582
"683","DL Bairstow (ENG)",125,17,0,17,68,0,68,0.544,0,0.544
"684","DL Freeman (NZ)",2,0,0,0,0,0,0,0,0,0
"685","DL Haynes (WI)",7533,837,24,861,3348,144,3492,0.444444444444444,0.019115890083632,0.463560334528076
"686","DL Houghton (ZIM)",1418,160,12,172,640,72,712,0.451339915373766,0.0507757404795487,0.502115655853315
"687","DL Maddy (ENG)",46,4,0,4,16,0,16,0.347826086956522,0,0.347826086956522
"688","DL Murray (WI)",1993,161,7,168,644,42,686,0.32313095835424,0.0210737581535374,0.344204716507777
"689","DL Piedt (SA)",48,2,0,2,8,0,8,0.166666666666667,0,0.166666666666667
"690","DL Underwood (ENG)",937,91,0,91,364,0,364,0.388473852721451,0,0.388473852721451
"691","DL Vettori (ICC)",8,0,0,0,0,0,0,0,0,0
"692","DL Vettori (NZ)",4523,556,17,573,2224,102,2326,0.491709042670794,0.0225514039354411,0.514260446606235
"693","DM Bess (ENG)",111,16,0,16,64,0,64,0.576576576576577,0,0.576576576576577
"694","DM Bravo (WI)",3400,390,39,429,1560,234,1794,0.458823529411765,0.0688235294117647,0.527647058823529
"695","DM de Silva (SL)",1186,151,7,158,604,42,646,0.509274873524452,0.0354131534569983,0.54468802698145
"696","DM Jones (AUS)",3631,361,10,371,1444,60,1504,0.397686587716882,0.01652437345084,0.414210961167722
"697","DM Lewis (WI)",259,20,0,20,80,0,80,0.308880308880309,0,0.308880308880309
"698","DM Richards (WI)",125,20,3,23,80,18,98,0.64,0.144,0.784
"699","DM Smith (ENG)",80,13,0,13,52,0,52,0.65,0,0.65
"700","DM Washington (WI)",7,1,0,1,4,0,4,0.571428571428571,0,0.571428571428571
"701","DM Wellham (AUS)",257,27,0,27,108,0,108,0.420233463035019,0,0.420233463035019
"702","DN Patel (NZ)",1200,119,8,127,476,48,524,0.396666666666667,0.04,0.436666666666667
"703","DN Sardesai (INDIA)",2001,204,2,206,816,12,828,0.407796101949025,0.00599700149925037,0.413793103448276
"704","DNT Zoysa (SL)",288,31,5,36,124,30,154,0.430555555555556,0.104166666666667,0.534722222222222
"705","DP Conyngham (SA)",6,0,0,0,0,0,0,0,0,0
"706","DP Samaraweera (SL)",211,18,0,18,72,0,72,0.341232227488152,0,0.341232227488152
"707","DP Viljoen (ZIM)",57,6,0,6,24,0,24,0.421052631578947,0,0.421052631578947
"708","DPB Morkel (SA)",663,8,3,11,32,18,50,0.0482654600301659,0.0271493212669683,0.0754147812971342
"709","DPMD Jayawardene (SL)",11722,1373,61,1434,5492,366,5858,0.46852073025081,0.0312233407268384,0.499744070977649
"710","DR Doshi (INDIA)",129,13,0,13,52,0,52,0.403100775193798,0,0.403100775193798
"711","DR Flynn (NZ)",1038,135,4,139,540,24,564,0.520231213872832,0.023121387283237,0.543352601156069
"712","DR Gilbert (AUS)",57,4,0,4,16,0,16,0.280701754385965,0,0.280701754385965
"713","DR Hadlee (NZ)",530,45,6,51,180,36,216,0.339622641509434,0.0679245283018868,0.407547169811321
"714","DR Jardine (ENG)",1296,53,0,53,212,0,212,0.16358024691358,0,0.16358024691358
"715","DR Martyn (AUS)",4406,513,10,523,2052,60,2112,0.46572855197458,0.0136177939173854,0.479346345891966
"716","DR O'Sullivan (NZ)",158,13,0,13,52,0,52,0.329113924050633,0,0.329113924050633
"717","DR Parry (WI)",381,32,1,33,128,6,134,0.335958005249344,0.015748031496063,0.351706036745407
"718","DR Pringle (ENG)",695,66,2,68,264,12,276,0.379856115107914,0.0172661870503597,0.397122302158273
"719","DR Smith (ENG)",38,3,2,5,12,12,24,0.315789473684211,0.315789473684211,0.631578947368421
"720","DR Smith (WI)",320,47,6,53,188,36,224,0.5875,0.1125,0.7
"721","DR Tuffey (NZ)",427,46,4,50,184,24,208,0.430913348946136,0.0562060889929742,0.48711943793911
"722","DRA Gehrs (AUS)",225,27,0,27,108,0,108,0.48,0,0.48
"723","DRE Joseph (WI)",141,18,1,19,72,6,78,0.51063829787234,0.0425531914893617,0.553191489361702
"724","DS Atkinson (WI)",922,46,6,52,184,36,220,0.199566160520607,0.0390455531453362,0.238611713665944
"725","DS de Silva (SL)",406,25,0,25,100,0,100,0.246305418719212,0,0.246305418719212
"726","DS Lehmann (AUS)",1798,214,10,224,856,60,916,0.476084538375973,0.0333704115684093,0.509454949944383
"727","DS Mohanty (INDIA)",0,0,0,0,0,0,0,NA,NA,NA
"728","DS Smith (WI)",1760,246,1,247,984,6,990,0.559090909090909,0.00340909090909091,0.5625
"729","DS Steele (ENG)",673,74,3,77,296,18,314,0.439821693907875,0.0267459138187221,0.466567607726597
"730","DS Tomlinson (SA)",9,2,0,2,8,0,8,0.888888888888889,0,0.888888888888889
"731","DSBP Kuruppu (SL)",366,47,0,47,188,0,188,0.513661202185792,0,0.513661202185792
"732","DT Dewdney (WI)",17,0,0,0,0,0,0,0,0,0
"733","DT Hondo (ZIM)",83,11,0,11,44,0,44,0.530120481927711,0,0.530120481927711
"734","DT Lindsay (SA)",1130,122,13,135,488,78,566,0.431858407079646,0.0690265486725664,0.500884955752212
"735","DT Mutendera (ZIM)",10,0,1,1,0,6,6,0,0.6,0.6
"736","DT Ring (AUS)",426,45,2,47,180,12,192,0.422535211267606,0.028169014084507,0.450704225352113
"737","DT Tiripano (ZIM)",219,28,1,29,112,6,118,0.511415525114155,0.0273972602739726,0.538812785388128
"738","DV Brennan (ENG)",16,0,0,0,0,0,0,0,0,0
"739","DV Dyer (SA)",96,0,0,0,0,0,0,0,0,0
"740","DV Lawrence (ENG)",60,7,0,7,28,0,28,0.466666666666667,0,0.466666666666667
"741","DV Smith (ENG)",25,2,0,2,8,0,8,0.32,0,0.32
"742","DVP Wright (ENG)",289,23,0,23,92,0,92,0.318339100346021,0,0.318339100346021
"743","DW Allan (WI)",75,0,0,0,0,0,0,0,0,0
"744","DW Begbie (SA)",138,9,1,10,36,6,42,0.260869565217391,0.0434782608695652,0.304347826086957
"745","DW Carr (ENG)",0,0,0,0,0,0,0,NA,NA,NA
"746","DW Fleming (AUS)",305,39,0,39,156,0,156,0.511475409836066,0,0.511475409836066
"747","DW Gregory (AUS)",60,0,0,0,0,0,0,0,0,0
"748","DW Headley (ENG)",186,18,0,18,72,0,72,0.387096774193548,0,0.387096774193548
"749","DW Hookes (AUS)",1306,147,5,152,588,30,618,0.450229709035222,0.0229709035222052,0.473200612557427
"750","DW Randall (ENG)",2470,254,5,259,1016,30,1046,0.411336032388664,0.0121457489878543,0.423481781376518
"751","DW Richardson (ENG)",33,3,0,3,12,0,12,0.363636363636364,0,0.363636363636364
"752","DW Steyn (SA)",1194,117,35,152,468,210,678,0.391959798994975,0.175879396984925,0.5678391959799
"753","DW White (ENG)",0,0,0,0,0,0,0,NA,NA,NA
"754","E Chigumbura (ZIM)",569,67,6,73,268,36,304,0.471001757469244,0.0632688927943761,0.53427065026362
"755","E Evans (AUS)",82,3,0,3,12,0,12,0.146341463414634,0,0.146341463414634
"756","E Jones (AUS)",126,5,0,5,20,0,20,0.158730158730159,0,0.158730158730159
"757","E Leadbeater (ENG)",40,0,0,0,0,0,0,0,0,0
"758","E Paynter (ENG)",1540,127,4,131,508,24,532,0.32987012987013,0.0155844155844156,0.345454545454545
"759","E Peate (ENG)",70,5,0,5,20,0,20,0.285714285714286,0,0.285714285714286
"760","E Wainwright (ENG)",132,2,0,2,8,0,8,0.0606060606060606,0,0.0606060606060606
"761","EA Brandes (ZIM)",121,11,3,14,44,18,62,0.363636363636364,0.148760330578512,0.512396694214876
"762","EA Halliwell (SA)",188,0,0,0,0,0,0,0,0,0
"763","EA Martindale (WI)",58,0,1,1,0,6,6,0,0.103448275862069,0.103448275862069
"764","EA McDonald (AUS)",108,15,1,16,60,6,66,0.555555555555556,0.0555555555555556,0.611111111111111
"765","EA Moseley (WI)",35,5,0,5,20,0,20,0.571428571428571,0,0.571428571428571
"766","EA van der Merwe (SA)",27,0,0,0,0,0,0,0,0,0
"767","EAB Rowan (SA)",1965,42,0,42,168,0,168,0.0854961832061069,0,0.0854961832061069
"768","EAC Hunte (WI)",166,0,0,0,0,0,0,0,0,0
"769","EAE Baptiste (WI)",233,27,1,28,108,6,114,0.463519313304721,0.0257510729613734,0.489270386266094
"770","EAR de Silva (SL)",185,8,0,8,32,0,32,0.172972972972973,0,0.172972972972973
"771","EAS Prasanna (INDIA)",735,65,0,65,260,0,260,0.353741496598639,0,0.353741496598639
"772","EAV Williams (WI)",113,7,4,11,28,24,52,0.247787610619469,0.212389380530973,0.460176991150442
"773","EB Lundie (SA)",1,0,0,0,0,0,0,0,0,0
"774","EC Joyce (IRE)",47,6,0,6,24,0,24,0.51063829787234,0,0.51063829787234
"775","EC Petrie (NZ)",258,10,0,10,40,0,40,0.155038759689922,0,0.155038759689922
"776","ED Solkar (INDIA)",1068,74,3,77,296,18,314,0.277153558052434,0.0168539325842697,0.294007490636704
"777","ED Weekes (WI)",4455,332,2,334,1328,12,1340,0.298092031425365,0.00269360269360269,0.300785634118967
"778","EDAS McMorris (WI)",564,3,0,3,12,0,12,0.0212765957446809,0,0.0212765957446809
"779","EE Achong (WI)",81,0,0,0,0,0,0,0,0,0
"780","EE Hemmings (ENG)",383,35,1,36,140,6,146,0.365535248041775,0.0156657963446475,0.381201044386423
"781","EFS Tylecote (ENG)",152,13,0,13,52,0,52,0.342105263157895,0,0.342105263157895
"782","EG Arnold (ENG)",160,5,0,5,20,0,20,0.125,0,0.125
"783","EG Bock (SA)",11,0,0,0,0,0,0,0,0,0
"784","EG Hayes (ENG)",94,7,1,8,28,6,34,0.297872340425532,0.0638297872340425,0.361702127659574
"785","EG McLeod (NZ)",18,0,0,0,0,0,0,0,0,0
"786","EG Wynyard (ENG)",72,4,0,4,16,0,16,0.222222222222222,0,0.222222222222222
"787","EH Bowley (ENG)",252,11,1,12,44,6,50,0.174603174603175,0.0238095238095238,0.198412698412698
"788","EH Bromley (AUS)",38,2,0,2,8,0,8,0.210526315789474,0,0.210526315789474
"789","EH Hendren (ENG)",3521,274,9,283,1096,54,1150,0.311275205907413,0.0153365521158762,0.326611758023289
"790","EH Mattis (WI)",145,20,1,21,80,6,86,0.551724137931034,0.0413793103448276,0.593103448275862
"791","Ehsan Adil (PAK)",21,3,0,3,12,0,12,0.571428571428571,0,0.571428571428571
"792","Ehsanul Haque (BDESH)",7,0,0,0,0,0,0,0,0,0
"793","Ehteshamuddin (PAK)",2,0,0,0,0,0,0,0,0,0
"794","EJ Barlow (SA)",2516,274,5,279,1096,30,1126,0.435612082670906,0.0119236883942766,0.447535771065183
"795","EJ Chatfield (NZ)",180,16,0,16,64,0,64,0.355555555555556,0,0.355555555555556
"796","EJ Gray (NZ)",248,20,0,20,80,0,80,0.32258064516129,0,0.32258064516129
"797","EJ Gregory (AUS)",11,1,0,1,4,0,4,0.363636363636364,0,0.363636363636364
"798","EJ Smith (ENG)",121,4,0,4,16,0,16,0.132231404958678,0,0.132231404958678
"799","EJ Tyler (ENG)",0,0,0,0,0,0,0,NA,NA,NA
"800","EJG Morgan (ENG)",700,77,6,83,308,36,344,0.44,0.0514285714285714,0.491428571428571
"801","EJK Burn (AUS)",41,0,0,0,0,0,0,0,0,0
"802","EJM Cowan (AUS)",1001,123,2,125,492,12,504,0.491508491508492,0.011988011988012,0.503496503496504
"803","EL a'Beckett (AUS)",143,12,0,12,48,0,48,0.335664335664336,0,0.335664335664336
"804","EL Bartlett (WI)",131,8,0,8,32,0,32,0.244274809160305,0,0.244274809160305
"805","EL Dalton (SA)",698,38,2,40,152,12,164,0.217765042979943,0.0171919770773639,0.234957020057307
"806","EL McCormick (AUS)",54,2,0,2,8,0,8,0.148148148148148,0,0.148148148148148
"807","EL St Hill (WI)",18,0,1,1,0,6,6,0,0.333333333333333,0.333333333333333
"808","ELG Hoad (WI)",98,0,0,0,0,0,0,0,0,0
"809","Elias Sunny (BDESH)",38,4,1,5,16,6,22,0.421052631578947,0.157894736842105,0.578947368421053
"810","EM Grace (ENG)",36,4,0,4,16,0,16,0.444444444444444,0,0.444444444444444
"811","EM Meuli (NZ)",38,0,0,0,0,0,0,0,0,0
"812","Enamul Haque (BDESH)",180,25,1,26,100,6,106,0.555555555555556,0.0333333333333333,0.588888888888889
"813","Enamul Haque jnr (BDESH)",59,7,0,7,28,0,28,0.474576271186441,0,0.474576271186441
"814","EP Nupen (SA)",348,5,3,8,20,18,38,0.0574712643678161,0.0517241379310345,0.109195402298851
"815","EQ Davies (SA)",9,0,0,0,0,0,0,0,0,0
"816","ER Dexter (ENG)",4502,513,16,529,2052,96,2148,0.455797423367392,0.0213238560639716,0.477121279431364
"817","ER Mayne (AUS)",64,1,0,1,4,0,4,0.0625,0,0.0625
"818","ER Wilson (ENG)",10,0,0,0,0,0,0,0,0,0
"819","ERH Fuller (SA)",64,5,1,6,20,6,26,0.3125,0.09375,0.40625
"820","ERH Toshack (AUS)",73,4,0,4,16,0,16,0.219178082191781,0,0.219178082191781
"821","ERNS Fernando (SL)",158,16,0,16,64,0,64,0.40506329113924,0,0.40506329113924
"822","ERT Holmes (ENG)",114,0,1,1,0,6,6,0,0.0526315789473684,0.0526315789473684
"823","ES Atkinson (WI)",126,0,1,1,0,6,6,0,0.0476190476190476,0.0476190476190476
"824","ES Maka (INDIA)",2,0,0,0,0,0,0,0,0,0
"825","ES Newson (SA)",30,1,0,1,4,0,4,0.133333333333333,0,0.133333333333333
"826","ESH Giddins (ENG)",10,1,0,1,4,0,4,0.4,0,0.4
"827","ESM Kentish (WI)",1,0,0,0,0,0,0,0,0,0
"828","ET Killick (ENG)",81,0,0,0,0,0,0,0,0,0
"829","ET Smith (ENG)",87,15,0,15,60,0,60,0.689655172413793,0,0.689655172413793
"830","ET Willett (WI)",74,4,0,4,16,0,16,0.216216216216216,0,0.216216216216216
"831","EW Clark (ENG)",36,0,0,0,0,0,0,0,0,0
"832","EW Dawson (ENG)",175,0,0,0,0,0,0,0,0,0
"833","EW Dempster (NZ)",106,0,0,0,0,0,0,0,0,0
"834","EW Freeman (AUS)",345,34,6,40,136,36,172,0.394202898550725,0.104347826086957,0.498550724637681
"835","EWT Tindill (NZ)",73,0,0,0,0,0,0,0,0,0
"836","EZ Matambanadzo (ZIM)",17,1,0,1,4,0,4,0.235294117647059,0,0.235294117647059
"837","F Barratt (ENG)",28,0,0,0,0,0,0,0,0,0
"838","F de Wet (SA)",20,3,0,3,12,0,12,0.6,0,0.6
"839","F du Plessis (SA)",3302,400,17,417,1600,102,1702,0.484554815263477,0.0308903694730466,0.515445184736523
"840","F Hearne (ENG)",47,4,0,4,16,0,16,0.340425531914894,0,0.340425531914894
"841","F Hearne (SA)",121,0,0,0,0,0,0,0,0,0
"842","F Kuys (SA)",26,0,0,0,0,0,0,0,0,0
"843","F Martin (ENG)",14,0,0,0,0,0,0,0,0,0
"844","F Mitchell (ENG)",88,0,0,0,0,0,0,0,0,0
"845","F Mitchell (SA)",28,0,0,0,0,0,0,0,0,0
"846","F Morley (ENG)",6,0,0,0,0,0,0,0,0,0
"847","F Mutizwa (ZIM)",24,3,0,3,12,0,12,0.5,0,0.5
"848","F Nicholson (SA)",76,2,1,3,8,6,14,0.105263157894737,0.0789473684210526,0.184210526315789
"849","F Penn (ENG)",50,6,0,6,24,0,24,0.48,0,0.48
"850","F Ridgway (ENG)",49,0,0,0,0,0,0,0,0,0
"851","FA Iredale (AUS)",807,59,0,59,236,0,236,0.292441140024783,0,0.292441140024783
"852","FA Lowson (ENG)",245,0,0,0,0,0,0,0,0,0
"853","FA MacKinnon (ENG)",5,0,0,0,0,0,0,0,0,0
"854","FA Rose (WI)",344,44,6,50,176,36,212,0.511627906976744,0.104651162790698,0.616279069767442
"855","FA Ward (AUS)",36,1,0,1,4,0,4,0.111111111111111,0,0.111111111111111
"856","Faheem Ashraf (PAK)",123,16,1,17,64,6,70,0.520325203252033,0.0487804878048781,0.569105691056911
"857","Fahim Muntasir (BDESH)",52,7,1,8,28,6,34,0.538461538461538,0.115384615384615,0.653846153846154
"858","Faisal Hossain (BDESH)",7,1,0,1,4,0,4,0.571428571428571,0,0.571428571428571
"859","Faisal Iqbal (PAK)",1124,136,5,141,544,30,574,0.483985765124555,0.0266903914590747,0.51067615658363
"860","Farhan Adil (PAK)",33,4,0,4,16,0,16,0.484848484848485,0,0.484848484848485
"861","Farooq Hamid (PAK)",3,0,0,0,0,0,0,0,0,0
"862","FAW Freer (AUS)",28,3,1,4,12,6,18,0.428571428571429,0.214285714285714,0.642857142857143
"863","Fawad Alam (PAK)",250,23,1,24,92,6,98,0.368,0.024,0.392
"864","Fazal Mahmood (PAK)",620,8,2,10,32,12,44,0.0516129032258065,0.0193548387096774,0.0709677419354839
"865","Fazl-e-Akbar (PAK)",52,9,0,9,36,0,36,0.692307692307692,0,0.692307692307692
"866","FB Smith (NZ)",237,12,3,15,48,18,66,0.20253164556962,0.0759493670886076,0.278481012658228
"867","FC Hayes (ENG)",244,27,1,28,108,6,114,0.442622950819672,0.0245901639344262,0.467213114754098
"868","FCM Alexander (WI)",961,51,2,53,204,12,216,0.212278876170656,0.0124869927159209,0.224765868886576
"869","FDM Karunaratne (SL)",3542,352,7,359,1408,42,1450,0.397515527950311,0.0118577075098814,0.409373235460192
"870","FE Allan (AUS)",5,0,0,0,0,0,0,0,0,0
"871","FE Fisher (NZ)",23,0,0,0,0,0,0,0,0,0
"872","FE Rumsey (ENG)",30,0,0,0,0,0,0,0,0,0
"873","FE Woolley (ENG)",3295,190,15,205,760,90,850,0.230652503793627,0.0273141122913505,0.257966616084977
"874","FG Mann (ENG)",376,30,2,32,120,12,132,0.319148936170213,0.0319148936170213,0.351063829787234
"875","FGJ Ford (ENG)",168,7,2,9,28,12,40,0.166666666666667,0.0714285714285714,0.238095238095238
"876","FH Edwards (WI)",394,48,2,50,192,12,204,0.487309644670051,0.0304568527918782,0.517766497461929
"877","FH Sugg (ENG)",55,0,0,0,0,0,0,0,0,0
"878","FH Tyson (ENG)",230,14,2,16,56,12,68,0.243478260869565,0.0521739130434783,0.295652173913043
"879","FH Walters (AUS)",12,2,0,2,8,0,8,0.666666666666667,0,0.666666666666667
"880","FI de Caires (WI)",232,4,0,4,16,0,16,0.0689655172413793,0,0.0689655172413793
"881","FJ Burton (AUS)",4,0,0,0,0,0,0,0,0,0
"882","FJ Cameron (NZ)",116,5,0,5,20,0,20,0.172413793103448,0,0.172413793103448
"883","FJ Cameron (WI)",151,12,0,12,48,0,48,0.317880794701987,0,0.317880794701987
"884","FJ Cook (SA)",7,0,0,0,0,0,0,0,0,0
"885","FJ Durston (ENG)",8,1,0,1,4,0,4,0.5,0,0.5
"886","FJ Laver (AUS)",196,0,0,0,0,0,0,0,0,0
"887","FJ Titmus (ENG)",1449,136,3,139,544,18,562,0.375431331953071,0.0124223602484472,0.387853692201518
"888","FL Fane (ENG)",682,49,0,49,196,0,196,0.287390029325513,0,0.287390029325513
"889","FL le Roux (SA)",1,0,0,0,0,0,0,0,0,0
"890","FL Reifer (WI)",111,12,0,12,48,0,48,0.432432432432432,0,0.432432432432432
"891","FLH Mooney (NZ)",343,1,0,1,4,0,4,0.0116618075801749,0,0.0116618075801749
"892","FM Engineer (INDIA)",2611,288,2,290,1152,12,1164,0.441210264266565,0.00459594025277671,0.445806204519341
"893","FM King (WI)",116,0,1,1,0,6,6,0,0.0517241379310345,0.0517241379310345
"894","FM Misson (AUS)",38,1,0,1,4,0,4,0.105263157894737,0,0.105263157894737
"895","FMM Worrell (WI)",3860,295,11,306,1180,66,1246,0.305699481865285,0.0170984455958549,0.32279792746114
"896","FR Brown (ENG)",734,57,5,62,228,30,258,0.310626702997275,0.0408719346049046,0.35149863760218
"897","FR Foster (ENG)",334,25,1,26,100,6,106,0.29940119760479,0.0179640718562874,0.317365269461078
"898","FR Martin (WI)",486,27,0,27,108,0,108,0.222222222222222,0,0.222222222222222
"899","FR Spofforth (AUS)",217,9,1,10,36,6,42,0.165898617511521,0.0276497695852535,0.193548387096774
"900","FS Ahangama (SL)",11,0,0,0,0,0,0,0,0,0
"901","FS Trueman (ENG)",981,60,25,85,240,150,390,0.244648318042813,0.152905198776758,0.397553516819572
"902","FT Badcock (NZ)",137,3,3,6,12,18,30,0.0875912408759124,0.131386861313869,0.218978102189781
"903","FT Mann (ENG)",273,11,6,17,44,36,80,0.161172161172161,0.131868131868132,0.293040293040293
"904","FW Milligan (ENG)",58,0,0,0,0,0,0,0,0,0
"905","FW Smith (SA)",45,1,0,1,4,0,4,0.0888888888888889,0,0.0888888888888889
"906","FW Tate (ENG)",9,1,0,1,4,0,4,0.444444444444444,0,0.444444444444444
"907","G Alexander (AUS)",52,5,0,5,20,0,20,0.384615384615385,0,0.384615384615385
"908","G Bean (ENG)",92,7,0,7,28,0,28,0.304347826086957,0,0.304347826086957
"909","G Boycott (ENG)",8160,772,8,780,3088,48,3136,0.37843137254902,0.00588235294117647,0.384313725490196
"910","G Brown (ENG)",299,24,0,24,96,0,96,0.321070234113712,0,0.321070234113712
"911","G Challenor (WI)",101,0,0,0,0,0,0,0,0,0
"912","G Cook (ENG)",203,20,0,20,80,0,80,0.394088669950739,0,0.394088669950739
"913","G Coulthard (AUS)",6,0,0,0,0,0,0,0,0,0
"914","G Cripps (SA)",21,0,0,0,0,0,0,0,0,0
"915","G Duckworth (ENG)",234,12,0,12,48,0,48,0.205128205128205,0,0.205128205128205
"916","G Dymock (AUS)",236,23,0,23,92,0,92,0.389830508474576,0,0.389830508474576
"917","G Fowler (ENG)",1307,145,3,148,580,18,598,0.443764345830145,0.0137719969395562,0.457536342769702
"918","G Gambhir (INDIA)",4154,518,10,528,2072,60,2132,0.498796340876264,0.0144439094848339,0.513240250361098
"919","G Geary (ENG)",249,21,0,21,84,0,84,0.337349397590361,0,0.337349397590361
"920","G Giffen (AUS)",1238,67,1,68,268,6,274,0.216478190630048,0.00484652665589661,0.221324717285945
"921","G Gladstone (WI)",12,2,0,2,8,0,8,0.666666666666667,0,0.666666666666667
"922","G Gunn (ENG)",1124,85,2,87,340,12,352,0.302491103202847,0.0106761565836299,0.313167259786477
"923","G Kirsten (SA)",7289,922,12,934,3688,72,3760,0.505967896830841,0.0098778982027713,0.515845795033612
"924","G Kishenchand (INDIA)",89,6,0,6,24,0,24,0.269662921348315,0,0.269662921348315
"925","G MacGregor (ENG)",96,2,0,2,8,0,8,0.0833333333333333,0,0.0833333333333333
"926","G Miller (ENG)",1213,119,0,119,476,0,476,0.392415498763397,0,0.392415498763397
"927","G Millman (ENG)",60,5,0,5,20,0,20,0.333333333333333,0,0.333333333333333
"928","G Noblet (AUS)",22,3,0,3,12,0,12,0.545454545454545,0,0.545454545454545
"929","G Onions (ENG)",30,4,0,4,16,0,16,0.533333333333333,0,0.533333333333333
"930","G Pullar (ENG)",1974,131,2,133,524,12,536,0.265450861195542,0.0060790273556231,0.271529888551165
"931","G Sharma (INDIA)",11,0,0,0,0,0,0,0,0,0
"932","G Thomas (AUS)",325,17,0,17,68,0,68,0.209230769230769,0,0.209230769230769
"933","G Thornton (SA)",1,0,0,0,0,0,0,0,0,0
"934","G Ulyett (ENG)",949,63,5,68,252,30,282,0.265542676501581,0.0316122233930453,0.297154899894626
"935","G Wijekoon (SL)",38,4,0,4,16,0,16,0.421052631578947,0,0.421052631578947
"936","GA Bartlett (NZ)",263,17,1,18,68,6,74,0.258555133079848,0.0228136882129278,0.281368821292776
"937","GA Briant (ZIM)",17,1,0,1,4,0,4,0.235294117647059,0,0.235294117647059
"938","GA Chevalier (SA)",0,0,0,0,0,0,0,NA,NA,NA
"939","GA Cope (ENG)",40,1,0,1,4,0,4,0.1,0,0.1
"940","GA Faulkner (SA)",1754,125,3,128,500,18,518,0.285062713797035,0.0102622576966933,0.295324971493729
"941","GA Gooch (ENG)",8900,1079,25,1104,4316,150,4466,0.484943820224719,0.0168539325842697,0.501797752808989
"942","GA Greenidge (WI)",209,20,0,20,80,0,80,0.382775119617225,0,0.382775119617225
"943","GA Headley (WI)",2190,135,1,136,540,6,546,0.246575342465753,0.00273972602739726,0.249315068493151
"944","GA Hick (ENG)",3383,450,22,472,1800,132,1932,0.532072125332545,0.0390186225243866,0.571090747856932
"945","GA Kempis (SA)",0,0,0,0,0,0,0,NA,NA,NA
"946","GA Lamb (ZIM)",46,4,0,4,16,0,16,0.347826086956522,0,0.347826086956522
"947","GA Lohmann (ENG)",213,13,1,14,52,6,58,0.244131455399061,0.028169014084507,0.272300469483568
"948","GA Manou (AUS)",21,3,0,3,12,0,12,0.571428571428571,0,0.571428571428571
"949","GA Rowe (SA)",26,0,0,0,0,0,0,0,0,0
"950","GA Smithson (ENG)",70,0,0,0,0,0,0,0,0,0
"951","GAE Paine (ENG)",97,0,1,1,0,6,6,0,0.0618556701030928,0.0618556701030928
"952","GAHM Parkar (INDIA)",7,1,0,1,4,0,4,0.571428571428571,0,0.571428571428571
"953","GAL Hearne (SA)",55,0,0,0,0,0,0,0,0,0
"954","GAR Lock (ENG)",742,68,1,69,272,6,278,0.366576819407008,0.00808625336927224,0.37466307277628
"955","GB Brent (ZIM)",35,2,0,2,8,0,8,0.228571428571429,0,0.228571428571429
"956","GB Hogg (AUS)",186,14,2,16,56,12,68,0.301075268817204,0.0645161290322581,0.365591397849462
"957","GB Hole (AUS)",789,70,0,70,280,0,280,0.354879594423321,0,0.354879594423321
"958","GB Lawrence (SA)",141,14,0,14,56,0,56,0.397163120567376,0,0.397163120567376
"959","GB Legge (ENG)",299,23,0,23,92,0,92,0.307692307692308,0,0.307692307692308
"960","GB Stevens (AUS)",112,0,0,0,0,0,0,0,0,0
"961","GB Stevenson (ENG)",28,4,1,5,16,6,22,0.571428571428571,0.214285714285714,0.785714285714286
"962","GB Street (ENG)",7,0,0,0,0,0,0,0,0,0
"963","GB Studd (ENG)",31,2,0,2,8,0,8,0.258064516129032,0,0.258064516129032
"964","GB Troup (NZ)",55,4,0,4,16,0,16,0.290909090909091,0,0.290909090909091
"965","GC Dyer (AUS)",131,11,0,11,44,0,44,0.33587786259542,0,0.33587786259542
"966","GC Grant (WI)",413,16,0,16,64,0,64,0.154963680387409,0,0.154963680387409
"967","GC Shillingford (WI)",57,0,1,1,0,6,6,0,0.105263157894737,0.105263157894737
"968","GC Small (ENG)",263,31,0,31,124,0,124,0.47148288973384,0,0.47148288973384
"969","GC Smith (ICC)",12,1,0,1,4,0,4,0.333333333333333,0,0.333333333333333
"970","GC Smith (SA)",9253,1164,24,1188,4656,144,4800,0.50318815519291,0.0155625202636983,0.518750675456609
"971","GC Tonge (WI)",25,2,0,2,8,0,8,0.32,0,0.32
"972","GC Viljoen (SA)",26,4,0,4,16,0,16,0.615384615384615,0,0.615384615384615
"973","GC White (SA)",876,55,4,59,220,24,244,0.251141552511416,0.0273972602739726,0.278538812785388
"974","GC Wilson (IRE)",45,7,0,7,28,0,28,0.622222222222222,0,0.622222222222222
"975","GD Barlow (ENG)",17,2,0,2,8,0,8,0.470588235294118,0,0.470588235294118
"976","GD Campbell (AUS)",10,0,0,0,0,0,0,0,0,0
"977","GD Elliott (NZ)",86,3,0,3,12,0,12,0.13953488372093,0,0.13953488372093
"978","GD McGrath (AUS)",641,51,1,52,204,6,210,0.318252730109204,0.0093603744149766,0.327613104524181
"979","GD McKenzie (AUS)",945,70,16,86,280,96,376,0.296296296296296,0.101587301587302,0.397883597883598
"980","GD Varnals (SA)",97,9,0,9,36,0,36,0.371134020618557,0,0.371134020618557
"981","GD Watson (AUS)",97,11,0,11,44,0,44,0.45360824742268,0,0.45360824742268
"982","GE Bond (SA)",0,0,0,0,0,0,0,NA,NA,NA
"983","GE Bradburn (NZ)",105,11,0,11,44,0,44,0.419047619047619,0,0.419047619047619
"984","GE Corling (AUS)",5,0,0,0,0,0,0,0,0,0
"985","GE Gomez (WI)",1243,37,0,37,148,0,148,0.119066773934031,0,0.119066773934031
"986","GE Palmer (AUS)",296,13,0,13,52,0,52,0.175675675675676,0,0.175675675675676
"987","GE Tribe (AUS)",35,6,0,6,24,0,24,0.685714285714286,0,0.685714285714286
"988","GE Tyldesley (ENG)",990,37,2,39,148,12,160,0.149494949494949,0.0121212121212121,0.161616161616162
"989","GE Vivian (NZ)",110,14,1,15,56,6,62,0.509090909090909,0.0545454545454545,0.563636363636364
"990","GEC Wood (ENG)",7,0,0,0,0,0,0,0,0,0
"991","GF Bissett (SA)",38,0,0,0,0,0,0,0,0,0
"992","GF Cresswell (NZ)",14,0,0,0,0,0,0,0,0,0
"993","GF Grace (ENG)",0,0,0,0,0,0,0,NA,NA,NA
"994","GF Labrooy (SL)",158,23,2,25,92,12,104,0.582278481012658,0.0759493670886076,0.658227848101266
"995","GF Lawson (AUS)",894,100,1,101,400,6,406,0.447427293064877,0.00671140939597315,0.45413870246085
"996","GF Rorke (AUS)",9,0,0,0,0,0,0,0,0,0
"997","GF Vernon (ENG)",14,0,0,0,0,0,0,0,0,0
"998","GFJ Liebenberg (SA)",104,14,0,14,56,0,56,0.538461538461538,0,0.538461538461538
"999","GG Arnold (ENG)",421,50,2,52,200,12,212,0.475059382422803,0.0285035629453682,0.503562945368171
"1000","GG Hall (SA)",0,0,0,0,0,0,0,NA,NA,NA
"1001","GG Hearne (ENG)",0,0,0,0,0,0,0,NA,NA,NA
"1002","GG Macaulay (ENG)",112,10,0,10,40,0,40,0.357142857142857,0,0.357142857142857
"1003","GH Hirst (ENG)",794,58,3,61,232,18,250,0.292191435768262,0.0226700251889169,0.314861460957179
"1004","GH Mudie (WI)",5,0,0,0,0,0,0,0,0,0
"1005","GH Pope (ENG)",8,0,0,0,0,0,0,0,0,0
"1006","GH Shepstone (SA)",38,0,0,0,0,0,0,0,0,0
"1007","GHG Doggart (ENG)",76,9,0,9,36,0,36,0.473684210526316,0,0.473684210526316
"1008","GHS Trott (AUS)",921,67,1,68,268,6,274,0.290988056460369,0.00651465798045603,0.297502714440825
"1009","GHT Simpson-Hayward (ENG)",105,0,0,0,0,0,0,0,0,0
"1010","Ghulam Abbas (PAK)",12,1,0,1,4,0,4,0.333333333333333,0,0.333333333333333
"1011","Ghulam Ahmed (INDIA)",192,0,3,3,0,18,18,0,0.09375,0.09375
"1012","GI Allott (NZ)",27,1,0,1,4,0,4,0.148148148148148,0,0.148148148148148
"1013","GJ Bailey (AUS)",183,15,8,23,60,48,108,0.327868852459016,0.262295081967213,0.590163934426229
"1014","GJ Batty (ENG)",149,15,2,17,60,12,72,0.402684563758389,0.0805369127516778,0.483221476510067
"1015","GJ Bonnor (AUS)",512,34,10,44,136,60,196,0.265625,0.1171875,0.3828125
"1016","GJ Cosier (AUS)",897,105,1,106,420,6,426,0.468227424749164,0.00668896321070234,0.474916387959866
"1017","GJ Crocker (ZIM)",69,5,1,6,20,6,26,0.289855072463768,0.0869565217391304,0.376811594202899
"1018","GJ Gilmour (AUS)",483,67,6,73,268,36,304,0.554865424430642,0.0745341614906832,0.629399585921325
"1019","GJ Hopkins (NZ)",71,8,0,8,32,0,32,0.450704225352113,0,0.450704225352113
"1020","GJ Maxwell (AUS)",339,33,7,40,132,42,174,0.389380530973451,0.123893805309735,0.513274336283186
"1021","GJ Rennie (ZIM)",1023,103,2,105,412,12,424,0.402737047898338,0.0117302052785924,0.414467253176931
"1022","GJ Thompson (ENG)",273,0,1,1,0,6,6,0,0.021978021978022,0.021978021978022
"1023","GJ Whittall (ZIM)",2207,261,7,268,1044,42,1086,0.473040326234708,0.019030357951971,0.492070684186679
"1024","GK Bruk-Jackson (ZIM)",39,6,0,6,24,0,24,0.615384615384615,0,0.615384615384615
"1025","GK Glover (SA)",21,0,0,0,0,0,0,0,0,0
"1026","GK Robertson (NZ)",12,2,0,2,8,0,8,0.666666666666667,0,0.666666666666667
"1027","GL Gibbs (WI)",12,0,0,0,0,0,0,0,0,0
"1028","GL Jessop (ENG)",569,61,3,64,244,18,262,0.428822495606327,0.031634446397188,0.460456942003515
"1029","GL Tapscott (SA)",9,0,0,0,0,0,0,0,0,0
"1030","GL Weir (NZ)",416,0,0,0,0,0,0,0,0,0
"1031","GL Wight (WI)",21,0,0,0,0,0,0,0,0,0
"1032","GM Carew (WI)",170,16,0,16,64,0,64,0.376470588235294,0,0.376470588235294
"1033","GM Emmett (ENG)",10,0,0,0,0,0,0,0,0,0
"1034","GM Ewing (ZIM)",108,14,1,15,56,6,62,0.518518518518518,0.0555555555555556,0.574074074074074
"1035","GM Fullerton (SA)",325,14,1,15,56,6,62,0.172307692307692,0.0184615384615385,0.190769230769231
"1036","GM Griffin (SA)",25,0,1,1,0,6,6,0,0.24,0.24
"1037","GM Guard (INDIA)",11,0,0,0,0,0,0,0,0,0
"1038","GM Hamilton (ENG)",0,0,0,0,0,0,0,NA,NA,NA
"1039","GM Parker (SA)",3,0,0,0,0,0,0,0,0,0
"1040","GM Ritchie (AUS)",1736,166,11,177,664,66,730,0.382488479262673,0.0380184331797235,0.420506912442396
"1041","GM Turner (NZ)",2991,265,0,265,1060,0,1060,0.354396522902039,0,0.354396522902039
"1042","GM Wood (AUS)",3420,321,8,329,1284,48,1332,0.375438596491228,0.0140350877192982,0.389473684210526
"1043","GN Edwards (NZ)",377,52,3,55,208,18,226,0.551724137931034,0.0477453580901857,0.59946949602122
"1044","GN Francis (WI)",81,1,0,1,4,0,4,0.0493827160493827,0,0.0493827160493827
"1045","GN Yallop (AUS)",2756,276,1,277,1104,6,1110,0.400580551523948,0.00217706821480406,0.402757619738752
"1046","GO Jones (ENG)",1172,155,12,167,620,72,692,0.52901023890785,0.0614334470989761,0.590443686006826
"1047","GO Rabone (NZ)",562,28,0,28,112,0,112,0.199288256227758,0,0.199288256227758
"1048","GOB Allen (ENG)",750,57,2,59,228,12,240,0.304,0.016,0.32
"1049","GP Bilby (NZ)",55,7,0,7,28,0,28,0.509090909090909,0,0.509090909090909
"1050","GP Howarth (NZ)",2531,255,1,256,1020,6,1026,0.403002765705255,0.00237060450414856,0.405373370209403
"1051","GP Swann (ENG)",1370,181,19,200,724,114,838,0.528467153284672,0.0832116788321168,0.611678832116788
"1052","GP Thorpe (ENG)",6652,765,9,774,3060,54,3114,0.460012026458208,0.00811785929043897,0.468129885748647
"1053","GP Wickramasinghe (SL)",555,69,4,73,276,24,300,0.497297297297297,0.0432432432432432,0.540540540540541
"1054","GPD Hartigan (SA)",118,0,0,0,0,0,0,0,0,0
"1055","GR Beard (AUS)",114,12,0,12,48,0,48,0.421052631578947,0,0.421052631578947
"1056","GR Breese (WI)",5,0,0,0,0,0,0,0,0,0
"1057","GR Dickinson (NZ)",31,0,0,0,0,0,0,0,0,0
"1058","GR Dilley (ENG)",521,63,0,63,252,0,252,0.483685220729367,0,0.483685220729367
"1059","GR Hazlitt (AUS)",93,7,0,7,28,0,28,0.301075268817204,0,0.301075268817204
"1060","GR Larsen (NZ)",127,17,0,17,68,0,68,0.535433070866142,0,0.535433070866142
"1061","GR Loveridge (NZ)",4,1,0,1,4,0,4,1,0,1
"1062","GR Marsh (AUS)",2854,307,1,308,1228,6,1234,0.430273300630694,0.00210231254379818,0.432375613174492
"1063","GR Robertson (AUS)",140,15,1,16,60,6,66,0.428571428571429,0.0428571428571429,0.471428571428571
"1064","GR Stead (NZ)",278,36,0,36,144,0,144,0.517985611510791,0,0.517985611510791
"1065","GR Sunderam (INDIA)",3,0,0,0,0,0,0,0,0,0
"1066","GR Thoms (AUS)",44,2,0,2,8,0,8,0.181818181818182,0,0.181818181818182
"1067","GR Viswanath (INDIA)",6126,622,6,628,2488,36,2524,0.406137773424747,0.00587659157688541,0.412014365001632
"1068","GRA de Silva (SL)",41,4,1,5,16,6,22,0.390243902439024,0.146341463414634,0.536585365853659
"1069","GRA Langley (AUS)",374,20,0,20,80,0,80,0.213903743315508,0,0.213903743315508
"1070","GRJ Matthews (AUS)",1849,166,5,171,664,30,694,0.359113034072472,0.0162249864791779,0.37533802055165
"1071","GRJ Roope (ENG)",860,86,2,88,344,12,356,0.4,0.013953488372093,0.413953488372093
"1072","GS Ballance (ENG)",1498,195,8,203,780,48,828,0.520694259012016,0.0320427236315087,0.552736982643525
"1073","GS Blewett (AUS)",2552,276,4,280,1104,24,1128,0.432601880877743,0.00940438871473354,0.442006269592476
"1074","GS Camacho (WI)",640,74,1,75,296,6,302,0.4625,0.009375,0.471875
"1075","GS Chappell (AUS)",7110,755,16,771,3020,96,3116,0.424753867791842,0.0135021097046414,0.438255977496484
"1076","GS Ramchand (INDIA)",1180,42,1,43,168,6,174,0.142372881355932,0.00508474576271186,0.147457627118644
"1077","GS Sobers (WI)",8032,726,32,758,2904,192,3096,0.361553784860558,0.0239043824701195,0.385458167330677
"1078","GT Dowling (NZ)",2306,200,14,214,800,84,884,0.346921075455334,0.0364267129228101,0.383347788378144
"1079","GTS Stevens (ENG)",263,6,2,8,24,12,36,0.091254752851711,0.0456273764258555,0.136882129277567
"1080","Gul Mohammad (INDIA)",166,18,0,18,72,0,72,0.433734939759036,0,0.433734939759036
"1081","Gul Mohammad (PAK)",39,0,0,0,0,0,0,0,0,0
"1082","Gursharan Singh (INDIA)",18,2,0,2,8,0,8,0.444444444444444,0,0.444444444444444
"1083","GW Flower (ZIM)",3411,341,16,357,1364,96,1460,0.399882732336558,0.0281442392260334,0.428026971562592
"1084","GWA Chubb (SA)",63,1,0,1,4,0,4,0.0634920634920635,0,0.0634920634920635
"1085","GWF Overton (NZ)",8,0,0,0,0,0,0,0,0,0
"1086","H Carter (AUS)",877,98,0,98,392,0,392,0.446978335233751,0,0.446978335233751
"1087","H Dean (ENG)",10,0,0,0,0,0,0,0,0,0
"1088","H Donnan (AUS)",75,2,0,2,8,0,8,0.106666666666667,0,0.106666666666667
"1089","H Foley (NZ)",4,0,0,0,0,0,0,0,0,0
"1090","H Gimblett (ENG)",129,11,1,12,44,6,50,0.341085271317829,0.0465116279069767,0.387596899224806
"1091","H Graham (AUS)",301,26,0,26,104,0,104,0.345514950166113,0,0.345514950166113
"1092","H Hameed (ENG)",219,23,2,25,92,12,104,0.420091324200913,0.0547945205479452,0.474885844748858
"1093","H Howell (ENG)",15,0,0,0,0,0,0,0,0,0
"1094","H Ironmonger (AUS)",42,4,0,4,16,0,16,0.380952380952381,0,0.380952380952381
"1095","H Jupp (ENG)",68,2,0,2,8,0,8,0.117647058823529,0,0.117647058823529
"1096","H Larwood (ENG)",485,42,2,44,168,12,180,0.34639175257732,0.0247422680412371,0.371134020618557
"1097","H Masakadza (ZIM)",2084,250,21,271,1000,126,1126,0.479846449136276,0.0604606525911708,0.540307101727447
"1098","H Morris (ENG)",115,12,0,12,48,0,48,0.417391304347826,0,0.417391304347826
"1099","H Moses (AUS)",198,9,1,10,36,6,42,0.181818181818182,0.0303030303030303,0.212121212121212
"1100","H Philipson (ENG)",63,1,0,1,4,0,4,0.0634920634920635,0,0.0634920634920635
"1101","H Smith (ENG)",7,0,0,0,0,0,0,0,0,0
"1102","H Strudwick (ENG)",226,12,0,12,48,0,48,0.212389380530973,0,0.212389380530973
"1103","H Sutcliffe (ENG)",4555,247,6,253,988,36,1024,0.216904500548847,0.00790340285400659,0.224807903402854
"1104","H Trumble (AUS)",851,33,0,33,132,0,132,0.155111633372503,0,0.155111633372503
"1105","H Verity (ENG)",669,17,0,17,68,0,68,0.101644245142003,0,0.101644245142003
"1106","H Wood (ENG)",204,11,0,11,44,0,44,0.215686274509804,0,0.215686274509804
"1107","HA Furlonge (WI)",99,9,0,9,36,0,36,0.363636363636364,0,0.363636363636364
"1108","HA Gomes (WI)",3171,258,2,260,1032,12,1044,0.325449385052034,0.00378429517502365,0.329233680227058
"1109","HA Musgrove (AUS)",13,0,0,0,0,0,0,0,0,0
"1110","Habibul Bashar (BDESH)",3026,401,4,405,1604,24,1628,0.530072703238599,0.00793126239259749,0.538003965631196
"1111","Hanif Mohammad (PAK)",3915,259,2,261,1036,12,1048,0.264623243933589,0.00306513409961686,0.267688378033206
"1112","Hannan Sarkar (BDESH)",662,90,0,90,360,0,360,0.54380664652568,0,0.54380664652568
"1113","Hanumant Singh (INDIA)",686,97,2,99,388,12,400,0.565597667638484,0.0174927113702624,0.583090379008746
"1114","HAPW Jayawardene (SL)",2124,223,15,238,892,90,982,0.419962335216573,0.0423728813559322,0.462335216572505
"1115","Harbhajan Singh (INDIA)",2224,277,42,319,1108,252,1360,0.498201438848921,0.113309352517986,0.611510791366906
"1116","Haris Sohail (PAK)",328,34,5,39,136,30,166,0.414634146341463,0.0914634146341463,0.50609756097561
"1117","Haroon Rasheed (PAK)",1217,112,19,131,448,114,562,0.368118323746919,0.0936729663105998,0.461791290057519
"1118","Harry Elliott (ENG)",61,0,0,0,0,0,0,0,0,0
"1119","Harvinder Singh (INDIA)",6,1,0,1,4,0,4,0.666666666666667,0,0.666666666666667
"1120","Hasan Ali (PAK)",93,10,6,16,40,36,76,0.43010752688172,0.387096774193548,0.817204301075269
"1121","Hasan Raza (PAK)",235,39,0,39,156,0,156,0.663829787234043,0,0.663829787234043
"1122","Haseeb Ahsan (PAK)",61,3,1,4,12,6,18,0.19672131147541,0.0983606557377049,0.295081967213115
"1123","Hashmatullah Shahidi (AFG)",47,8,0,8,32,0,32,0.680851063829787,0,0.680851063829787
"1124","Hasibul Hossain (BDESH)",97,10,3,13,40,18,58,0.412371134020619,0.185567010309278,0.597938144329897
"1125","HB Cameron (SA)",1239,43,11,54,172,66,238,0.138821630347054,0.0532687651331719,0.192090395480226
"1126","HB Cave (NZ)",229,5,0,5,20,0,20,0.0873362445414847,0,0.0873362445414847
"1127","HB Taber (AUS)",353,20,0,20,80,0,80,0.226628895184136,0,0.226628895184136
"1128","HC Griffith (WI)",91,2,0,2,8,0,8,0.0879120879120879,0,0.0879120879120879
"1129","HC Nitschke (AUS)",53,3,0,3,12,0,12,0.226415094339623,0,0.226415094339623
"1130","HD Ackerman (SA)",161,15,0,15,60,0,60,0.372670807453416,0,0.372670807453416
"1131","HD Bromfield (SA)",59,3,0,3,12,0,12,0.203389830508475,0,0.203389830508475
"1132","HD Rutherford (NZ)",755,98,9,107,392,54,446,0.519205298013245,0.071523178807947,0.590728476821192
"1133","HD Smith (NZ)",4,0,0,0,0,0,0,0,0,0
"1134","HDG Leveson Gower (ENG)",95,0,0,0,0,0,0,0,0,0
"1135","HDPK Dharmasena (SL)",868,91,2,93,364,12,376,0.419354838709677,0.0138248847926267,0.433179723502304
"1136","HDRL Thirimanne (SL)",1153,113,3,116,452,18,470,0.392020815264527,0.01561144839549,0.407632263660017
"1137","HE Dollery (ENG)",72,1,0,1,4,0,4,0.0555555555555556,0,0.0555555555555556
"1138","HF Boyle (AUS)",153,12,0,12,48,0,48,0.313725490196078,0,0.313725490196078
"1139","HF Wade (SA)",327,5,0,5,20,0,20,0.0611620795107034,0,0.0611620795107034
"1140","HG Deane (SA)",624,0,1,1,0,6,6,0,0.00961538461538462,0.00961538461538462
"1141","HG Gaekwad (INDIA)",22,0,0,0,0,0,0,0,0,0
"1142","HG Kuhn (SA)",113,18,0,18,72,0,72,0.63716814159292,0,0.63716814159292
"1143","HG Vivian (NZ)",421,15,3,18,60,18,78,0.142517814726841,0.0427553444180523,0.185273159144893
"1144","HGO Owen-Smith (SA)",252,0,2,2,0,12,12,0,0.0476190476190476,0.0476190476190476
"1145","HH Alexander (AUS)",17,2,0,2,8,0,8,0.470588235294118,0,0.470588235294118
"1146","HH Dippenaar (SA)",1718,237,5,242,948,30,978,0.551804423748545,0.0174621653084983,0.569266589057043
"1147","HH Francis (SA)",39,0,0,0,0,0,0,0,0,0
"1148","HH Gibbs (SA)",6121,878,47,925,3512,282,3794,0.573762457114851,0.0460709034471492,0.619833360562
"1149","HH Kanitkar (INDIA)",74,8,0,8,32,0,32,0.432432432432432,0,0.432432432432432
"1150","HH Massie (AUS)",249,35,0,35,140,0,140,0.562248995983936,0,0.562248995983936
"1151","HH Pandya (INDIA)",532,68,12,80,272,72,344,0.511278195488722,0.135338345864662,0.646616541353383
"1152","HH Streak (ZIM)",1990,212,12,224,848,72,920,0.426130653266332,0.0361809045226131,0.462311557788945
"1153","HHH Johnson (WI)",38,3,2,5,12,12,24,0.315789473684211,0.315789473684211,0.631578947368421
"1154","HI Ebeling (AUS)",43,0,0,0,0,0,0,0,0,0
"1155","HI Young (ENG)",43,0,0,0,0,0,0,0,0,0
"1156","HJ Butler (ENG)",15,0,0,0,0,0,0,0,0,0
"1157","HJ Howarth (NZ)",291,28,0,28,112,0,112,0.384879725085911,0,0.384879725085911
"1158","HJ Keith (SA)",318,36,0,36,144,0,144,0.452830188679245,0,0.452830188679245
"1159","HJ Rhodes (ENG)",0,0,0,0,0,0,0,NA,NA,NA
"1160","HJ Tayfield (SA)",862,26,5,31,104,30,134,0.120649651972158,0.0348027842227378,0.155452436194896
"1161","HJH Marshall (NZ)",652,83,3,86,332,18,350,0.50920245398773,0.0276073619631902,0.53680981595092
"1162","HJH Scott (AUS)",359,31,0,31,124,0,124,0.345403899721448,0,0.345403899721448
"1163","HK Badani (INDIA)",94,11,1,12,44,6,50,0.468085106382979,0.0638297872340425,0.531914893617021
"1164","HK Bennett (NZ)",4,0,0,0,0,0,0,0,0,0
"1165","HK Jayantilal (INDIA)",5,1,0,1,4,0,4,0.8,0,0.8
"1166","HK Olonga (ZIM)",184,17,2,19,68,12,80,0.369565217391304,0.0652173913043478,0.434782608695652
"1167","HL Collins (AUS)",1348,123,0,123,492,0,492,0.364985163204748,0,0.364985163204748
"1168","HL Jackson (ENG)",15,3,0,3,12,0,12,0.8,0,0.8
"1169","HLE Promnitz (SA)",10,0,0,0,0,0,0,0,0,0
"1170","HM Amla (SA)",9022,1129,14,1143,4516,84,4600,0.500554200842385,0.00931057415207271,0.509864774994458
"1171","HM Goonatilleke (SL)",177,21,0,21,84,0,84,0.474576271186441,0,0.474576271186441
"1172","HM McGirr (NZ)",51,0,0,0,0,0,0,0,0,0
"1173","HM Nicholls (NZ)",850,106,0,106,424,0,424,0.498823529411765,0,0.498823529411765
"1174","HM Taberer (SA)",2,0,0,0,0,0,0,0,0,0
"1175","HM Thurlow (AUS)",0,0,0,0,0,0,0,NA,NA,NA
"1176","HMCM Bandara (SL)",124,14,2,16,56,12,68,0.451612903225806,0.0967741935483871,0.548387096774194
"1177","HMRKB Herath (SL)",1680,199,6,205,796,36,832,0.473809523809524,0.0214285714285714,0.495238095238095
"1178","Hon.A Lyttelton (ENG)",94,4,0,4,16,0,16,0.170212765957447,0,0.170212765957447
"1179","Hon.CJ Coventry (ENG)",13,2,0,2,8,0,8,0.615384615384615,0,0.615384615384615
"1180","Hon.FS Jackson (ENG)",1415,118,0,118,472,0,472,0.33356890459364,0,0.33356890459364
"1181","Hon.FSG Calthorpe (ENG)",129,0,0,0,0,0,0,0,0,0
"1182","Hon.IFW Bligh (ENG)",62,6,0,6,24,0,24,0.387096774193548,0,0.387096774193548
"1183","HP Tillakaratne (SL)",4545,540,1,541,2160,6,2166,0.475247524752475,0.00132013201320132,0.476567656765677
"1184","HR Adhikari (INDIA)",872,28,1,29,112,6,118,0.128440366972477,0.00688073394495413,0.135321100917431
"1185","HR Bromley-Davenport (ENG)",128,0,0,0,0,0,0,0,0,0
"1186","HR Butt (ENG)",22,0,0,0,0,0,0,0,0,0
"1187","HR Lance (SA)",591,42,6,48,168,36,204,0.284263959390863,0.0609137055837563,0.345177664974619
"1188","HRJ Charlwood (ENG)",63,3,0,3,12,0,12,0.19047619047619,0,0.19047619047619
"1189","HS Chang (WI)",8,0,0,0,0,0,0,0,0,0
"1190","HS Kanitkar (INDIA)",111,17,0,17,68,0,68,0.612612612612613,0,0.612612612612613
"1191","HSB Love (AUS)",8,0,0,0,0,0,0,0,0,0
"1192","HSTL Hendry (AUS)",331,27,0,27,108,0,108,0.326283987915408,0,0.326283987915408
"1193","HT Davis (NZ)",20,1,0,1,4,0,4,0.2,0,0.2
"1194","HTW Hardinge (ENG)",30,2,0,2,8,0,8,0.266666666666667,0,0.266666666666667
"1195","Humayun Farhat (PAK)",54,6,3,9,24,18,42,0.444444444444444,0.333333333333333,0.777777777777778
"1196","HV Baumgartner (SA)",19,0,0,0,0,0,0,0,0,0
"1197","HV Hordern (AUS)",258,23,0,23,92,0,92,0.356589147286822,0,0.356589147286822
"1198","HW Chapman (SA)",35,0,0,0,0,0,0,0,0,0
"1199","HW Lee (ENG)",19,0,0,0,0,0,0,0,0,0
"1200","HW Taylor (SA)",2932,98,7,105,392,42,434,0.133697135061392,0.014324693042292,0.148021828103684
"1201","HWR Cartwright (AUS)",55,7,1,8,28,6,34,0.509090909090909,0.109090909090909,0.618181818181818
"1202","I Khan (SA)",20,1,0,1,4,0,4,0.2,0,0.2
"1203","I Meckiff (AUS)",154,1,0,1,4,0,4,0.025974025974026,0,0.025974025974026
"1204","I Sharma (INDIA)",613,69,0,69,276,0,276,0.450244698205546,0,0.450244698205546
"1205","IA Colquhoun (NZ)",1,0,0,0,0,0,0,0,0,0
"1206","IA Greig (ENG)",26,2,0,2,8,0,8,0.307692307692308,0,0.307692307692308
"1207","IA Healy (AUS)",4356,425,5,430,1700,30,1730,0.390266299357208,0.0068870523415978,0.397153351698806
"1208","IAR Peebles (ENG)",98,2,0,2,8,0,8,0.0816326530612245,0,0.0816326530612245
"1209","IB Cromb (NZ)",123,5,2,7,20,12,32,0.16260162601626,0.0975609756097561,0.260162601626016
"1210","IB Leggat (NZ)",0,0,0,0,0,0,0,NA,NA,NA
"1211","IBA Allen (WI)",5,1,0,1,4,0,4,0.8,0,0.8
"1212","IC Davis (AUS)",692,67,2,69,268,12,280,0.38728323699422,0.0173410404624277,0.404624277456647
"1213","ID Blackwell (ENG)",4,0,0,0,0,0,0,0,0,0
"1214","ID Buys (SA)",4,0,0,0,0,0,0,0,0,0
"1215","ID Craig (AUS)",358,17,0,17,68,0,68,0.189944134078212,0,0.189944134078212
"1216","IDK Salisbury (ENG)",368,44,0,44,176,0,176,0.478260869565217,0,0.478260869565217
"1217","IDR Bradshaw (WI)",96,11,0,11,44,0,44,0.458333333333333,0,0.458333333333333
"1218","IDS Smith (NZ)",1815,231,7,238,924,42,966,0.509090909090909,0.0231404958677686,0.532231404958678
"1219","IE O'Brien (NZ)",219,29,1,30,116,6,122,0.529680365296804,0.0273972602739726,0.557077625570776
"1220","Iftikhar Ahmed (PAK)",4,1,0,1,4,0,4,1,0,1
"1221","Iftikhar Anjum (PAK)",9,2,0,2,8,0,8,0.888888888888889,0,0.888888888888889
"1222","IG Butler (NZ)",76,10,1,11,40,6,46,0.526315789473684,0.0789473684210526,0.605263157894737
"1223","IJ Jones (ENG)",38,5,0,5,20,0,20,0.526315789473684,0,0.526315789473684
"1224","IJ Siedle (SA)",977,38,1,39,152,6,158,0.155578300921187,0.00614124872057318,0.16171954964176
"1225","IJ Ward (ENG)",129,8,0,8,32,0,32,0.248062015503876,0,0.248062015503876
"1226","Ijaz Ahmed (PAK)",3315,417,23,440,1668,138,1806,0.50316742081448,0.0416289592760181,0.544796380090498
"1227","Ijaz Ahmed jnr (PAK)",29,4,0,4,16,0,16,0.551724137931034,0,0.551724137931034
"1228","Ijaz Butt (PAK)",279,2,0,2,8,0,8,0.028673835125448,0,0.028673835125448
"1229","Ijaz Faqih (PAK)",183,16,4,20,64,24,88,0.349726775956284,0.131147540983607,0.480874316939891
"1230","IJL Trott (ENG)",3835,451,0,451,1804,0,1804,0.470404172099087,0,0.470404172099087
"1231","IK Pathan (INDIA)",1105,131,18,149,524,108,632,0.47420814479638,0.097737556561086,0.571945701357466
"1232","IL Mendonca (WI)",81,0,0,0,0,0,0,0,0,0
"1233","IM Barrow (WI)",276,3,0,3,12,0,12,0.0434782608695652,0,0.0434782608695652
"1234","IM Chappell (AUS)",5345,562,15,577,2248,90,2338,0.420579981290926,0.0168381665107577,0.437418147801684
"1235","IM Sinclair (NZ)",25,4,0,4,16,0,16,0.64,0,0.64
"1236","Imam-ul-Haq (PAK)",137,17,0,17,68,0,68,0.496350364963504,0,0.496350364963504
"1237","Imran Farhat (PAK)",2400,348,4,352,1392,24,1416,0.58,0.01,0.59
"1238","Imran Khan (PAK)",3859,335,55,390,1340,330,1670,0.347240217672972,0.0855143819642394,0.432754599637212
"1239","Imran Nazir (PAK)",427,63,4,67,252,24,276,0.590163934426229,0.0562060889929742,0.646370023419204
"1240","Imran Tahir (SA)",130,18,1,19,72,6,78,0.553846153846154,0.0461538461538462,0.6
"1241","Imrul Kayes (BDESH)",1679,226,11,237,904,66,970,0.538415723645027,0.0393091125670042,0.577724836212031
"1242","Imtiaz Ahmed (PAK)",2079,102,3,105,408,18,426,0.196248196248196,0.00865800865800866,0.204906204906205
"1243","Imtiaz Ali (WI)",1,0,0,0,0,0,0,0,0,0
"1244","Inshan Ali (WI)",172,13,0,13,52,0,52,0.302325581395349,0,0.302325581395349
"1245","Intikhab Alam (PAK)",1493,116,16,132,464,96,560,0.310783657066309,0.0643000669792364,0.375083724045546
"1246","Inzamam-ul-Haq (ICC)",1,0,0,0,0,0,0,0,0,0
"1247","Inzamam-ul-Haq (PAK)",8829,1105,48,1153,4420,288,4708,0.500622947106128,0.0326197757390418,0.533242722845169
"1248","IP Butchart (ZIM)",23,3,0,3,12,0,12,0.521739130434783,0,0.521739130434783
"1249","Iqbal Qasim (PAK)",549,46,0,46,184,0,184,0.335154826958106,0,0.335154826958106
"1250","IR Bell (ENG)",7727,919,39,958,3676,234,3910,0.475734437686036,0.0302834217678271,0.506017859453863
"1251","IR Bishop (WI)",632,62,2,64,248,12,260,0.392405063291139,0.0189873417721519,0.411392405063291
"1252","IR Redpath (AUS)",4737,481,2,483,1924,12,1936,0.406164238969812,0.00253324889170361,0.408697487861516
"1253","IR Siddiqui (INDIA)",29,3,1,4,12,6,18,0.413793103448276,0.206896551724138,0.620689655172414
"1254","Irfan Fazil (PAK)",4,0,0,0,0,0,0,0,0,0
"1255","IS Gallage (SL)",3,0,0,0,0,0,0,0,0,0
"1256","IS Madray (WI)",3,0,0,0,0,0,0,0,0,0
"1257","IS Sodhi (NZ)",422,49,6,55,196,36,232,0.464454976303318,0.0853080568720379,0.549763033175355
"1258","Israr Ali (PAK)",33,0,0,0,0,0,0,0,0,0
"1259","IT Botham (ENG)",5292,635,67,702,2540,402,2942,0.479969765684051,0.0759637188208617,0.555933484504913
"1260","IT Shillingford (WI)",218,18,1,19,72,6,78,0.330275229357798,0.0275229357798165,0.357798165137615
"1261","IVA Richards (WI)",8540,1051,84,1135,4204,504,4708,0.492271662763466,0.059016393442623,0.551288056206089
"1262","IW Callen (AUS)",26,2,1,3,8,6,14,0.307692307692308,0.230769230769231,0.538461538461538
"1263","IWG Johnson (AUS)",1000,53,2,55,212,12,224,0.212,0.012,0.224
"1264","J Angel (AUS)",35,6,0,6,24,0,24,0.685714285714286,0,0.685714285714286
"1265","J Arnold (ENG)",34,5,0,5,20,0,20,0.588235294117647,0,0.588235294117647
"1266","J Arun Lal (INDIA)",729,66,0,66,264,0,264,0.362139917695473,0,0.362139917695473
"1267","J Benaud (AUS)",223,24,3,27,96,18,114,0.430493273542601,0.0807174887892377,0.511210762331839
"1268","J Birkenshaw (ENG)",148,13,0,13,52,0,52,0.351351351351351,0,0.351351351351351
"1269","J Blackwood (WI)",1324,155,26,181,620,156,776,0.468277945619335,0.117824773413897,0.586102719033233
"1270","J Botha (SA)",83,9,0,9,36,0,36,0.433734939759036,0,0.433734939759036
"1271","J Briggs (ENG)",815,68,0,68,272,0,272,0.333742331288344,0,0.333742331288344
"1272","J Cowie (NZ)",90,4,1,5,16,6,22,0.177777777777778,0.0666666666666667,0.244444444444444
"1273","J Cranston (ENG)",31,0,0,0,0,0,0,0,0,0
"1274","J Darling (AUS)",1657,141,9,150,564,54,618,0.340374170187085,0.0325890162945081,0.372963186481593
"1275","J Dyson (AUS)",1359,123,3,126,492,18,510,0.362030905077263,0.0132450331125828,0.375275938189845
"1276","J Garner (WI)",764,64,16,80,256,96,352,0.335078534031414,0.12565445026178,0.460732984293194
"1277","J Hardstaff jnr (ENG)",1636,119,3,122,476,18,494,0.290953545232274,0.0110024449877751,0.301955990220049
"1278","J Hardstaff snr (ENG)",311,37,0,37,148,0,148,0.47588424437299,0,0.47588424437299
"1279","J Harry (AUS)",8,0,0,0,0,0,0,0,0,0
"1280","J Humphries (ENG)",44,3,0,3,12,0,12,0.272727272727273,0,0.272727272727273
"1281","J Hunter (ENG)",93,8,1,9,32,6,38,0.344086021505376,0.0645161290322581,0.408602150537634
"1282","J Iddon (ENG)",170,0,0,0,0,0,0,0,0,0
"1283","J Lewis (ENG)",27,5,0,5,20,0,20,0.740740740740741,0,0.740740740740741
"1284","J McIlwraith (AUS)",9,0,0,0,0,0,0,0,0,0
"1285","J Middleton (SA)",52,0,0,0,0,0,0,0,0,0
"1286","J Moroney (AUS)",383,15,0,15,60,0,60,0.156657963446475,0,0.156657963446475
"1287","J Mubarak (SL)",385,50,3,53,200,18,218,0.519480519480519,0.0467532467532468,0.566233766233766
"1288","J Newman (NZ)",33,0,0,0,0,0,0,0,0,0
"1289","J Nyumbu (ZIM)",38,2,2,4,8,12,20,0.210526315789474,0.315789473684211,0.526315789473684
"1290","J O'Connor (ENG)",153,8,1,9,32,6,38,0.209150326797386,0.0392156862745098,0.248366013071895
"1291","J Ormond (ENG)",38,3,0,3,12,0,12,0.315789473684211,0,0.315789473684211
"1292","J Ryder (AUS)",1394,102,3,105,408,18,426,0.292682926829268,0.0129124820659971,0.305595408895265
"1293","J Selby (ENG)",256,16,0,16,64,0,64,0.25,0,0.25
"1294","J Sharp (ENG)",188,11,0,11,44,0,44,0.234042553191489,0,0.234042553191489
"1295","J Shuter (ENG)",28,0,0,0,0,0,0,0,0,0
"1296","J Slight (AUS)",11,1,0,1,4,0,4,0.363636363636364,0,0.363636363636364
"1297","J Southerton (ENG)",7,0,0,0,0,0,0,0,0,0
"1298","J Srinath (INDIA)",1009,110,8,118,440,48,488,0.43607532210109,0.0475718533201189,0.483647175421209
"1299","J Trim (WI)",21,0,0,0,0,0,0,0,0,0
"1300","J Vine (ENG)",46,5,0,5,20,0,20,0.434782608695652,0,0.434782608695652
"1301","J Worrall (AUS)",478,46,0,46,184,0,184,0.384937238493724,0,0.384937238493724
"1302","J Yadav (INDIA)",228,28,0,28,112,0,112,0.491228070175439,0,0.491228070175439
"1303","JA Burns (AUS)",919,119,10,129,476,60,536,0.517954298150163,0.0652883569096844,0.583242655059848
"1304","JA Dunning (NZ)",38,0,0,0,0,0,0,0,0,0
"1305","JA Flavell (ENG)",31,4,0,4,16,0,16,0.516129032258065,0,0.516129032258065
"1306","JA Hayes (NZ)",73,3,2,5,12,12,24,0.164383561643836,0.164383561643836,0.328767123287671
"1307","JA Jameson (ENG)",214,25,3,28,100,18,118,0.467289719626168,0.0841121495327103,0.551401869158878
"1308","JA Maclean (AUS)",79,5,0,5,20,0,20,0.253164556962025,0,0.253164556962025
"1309","JA Morkel (SA)",58,10,1,11,40,6,46,0.689655172413793,0.103448275862069,0.793103448275862
"1310","JA Raval (NZ)",648,85,0,85,340,0,340,0.524691358024691,0,0.524691358024691
"1311","JA Rennie (ZIM)",62,3,0,3,12,0,12,0.193548387096774,0,0.193548387096774
"1312","JA Rudolph (SA)",2622,362,7,369,1448,42,1490,0.552250190694127,0.0160183066361556,0.568268497330282
"1313","JA Small (WI)",79,0,0,0,0,0,0,0,0,0
"1314","JA Snow (ENG)",772,73,4,77,292,24,316,0.378238341968912,0.0310880829015544,0.409326424870466
"1315","JA Warrican (WI)",65,9,0,9,36,0,36,0.553846153846154,0,0.553846153846154
"1316","JA Young (ENG)",28,2,0,2,8,0,8,0.285714285714286,0,0.285714285714286
"1317","JAH Marshall (NZ)",218,29,0,29,116,0,116,0.532110091743119,0,0.532110091743119
"1318","Jahurul Islam (BDESH)",347,37,4,41,148,24,172,0.426512968299712,0.069164265129683,0.495677233429395
"1319","JAJ Christy (SA)",618,24,3,27,96,18,114,0.155339805825243,0.029126213592233,0.184466019417476
"1320","JAK Cochran (SA)",4,1,0,1,4,0,4,1,0,1
"1321","Jalal-ud-Din (PAK)",3,0,0,0,0,0,0,0,0,0
"1322","James Langridge (ENG)",242,0,0,0,0,0,0,0,0,0
"1323","James Lillywhite jnr (ENG)",16,1,0,1,4,0,4,0.25,0,0.25
"1324","Javed Ahmadi (AFG)",4,0,0,0,0,0,0,0,0,0
"1325","Javed Akhtar (PAK)",4,0,0,0,0,0,0,0,0,0
"1326","Javed Burki (PAK)",1341,114,3,117,456,18,474,0.340044742729307,0.0134228187919463,0.353467561521253
"1327","Javed Miandad (PAK)",8970,819,48,867,3276,288,3564,0.365217391304348,0.0321070234113712,0.397324414715719
"1328","Javed Omar (BDESH)",1720,240,1,241,960,6,966,0.558139534883721,0.00348837209302326,0.561627906976744
"1329","JB Bolus (ENG)",496,47,0,47,188,0,188,0.379032258064516,0,0.379032258064516
"1330","JB Commins (SA)",125,12,0,12,48,0,48,0.384,0,0.384
"1331","JB Gannon (AUS)",3,0,0,0,0,0,0,0,0,0
"1332","JB Hobbs (ENG)",5414,316,8,324,1264,48,1312,0.233468784632434,0.00886590321388992,0.242334687846324
"1333","JB Iverson (AUS)",3,0,0,0,0,0,0,0,0,0
"1334","JB Mortimore (ENG)",243,27,4,31,108,24,132,0.444444444444444,0.0987654320987654,0.54320987654321
"1335","JB Plimsoll (SA)",16,0,0,0,0,0,0,0,0,0
"1336","JB Robertson (SA)",51,3,0,3,12,0,12,0.235294117647059,0,0.235294117647059
"1337","JB Statham (ENG)",675,35,5,40,140,30,170,0.207407407407407,0.0444444444444444,0.251851851851852
"1338","JB Stollmeyer (WI)",2159,78,3,81,312,18,330,0.144511347846225,0.00833719314497453,0.1528485409912
"1339","JC Adams (WI)",3012,313,4,317,1252,24,1276,0.415670650730412,0.00796812749003984,0.423638778220452
"1340","JC Alabaster (NZ)",272,11,0,11,44,0,44,0.161764705882353,0,0.161764705882353
"1341","JC Balderstone (ENG)",39,3,0,3,12,0,12,0.307692307692308,0,0.307692307692308
"1342","JC Buttler (ENG)",1216,154,15,169,616,90,706,0.506578947368421,0.0740131578947368,0.580592105263158
"1343","JC Hartley (ENG)",15,2,0,2,8,0,8,0.533333333333333,0,0.533333333333333
"1344","JC Hill (AUS)",21,2,0,2,8,0,8,0.380952380952381,0,0.380952380952381
"1345","JC Laker (ENG)",676,43,2,45,172,12,184,0.254437869822485,0.0177514792899408,0.272189349112426
"1346","JC Reedman (AUS)",21,1,1,2,4,6,10,0.19047619047619,0.285714285714286,0.476190476190476
"1347","JC Tredwell (ENG)",45,6,0,6,24,0,24,0.533333333333333,0,0.533333333333333
"1348","JC Watkins (SA)",612,37,1,38,148,6,154,0.241830065359477,0.00980392156862745,0.251633986928105
"1349","JC White (ENG)",239,11,0,11,44,0,44,0.184100418410042,0,0.184100418410042
"1350","JD Edwards (AUS)",48,0,0,0,0,0,0,0,0,0
"1351","JD Higgs (AUS)",111,6,0,6,24,0,24,0.216216216216216,0,0.216216216216216
"1352","JD Lindsay (SA)",21,0,0,0,0,0,0,0,0,0
"1353","JD Nel (SA)",150,0,0,0,0,0,0,0,0,0
"1354","JD Ryder (NZ)",1269,146,6,152,584,36,620,0.460204885736801,0.0283687943262411,0.488573680063042
"1355","JD Unadkat (INDIA)",2,0,0,0,0,0,0,0,0,0
"1356","JDA O'Connor (AUS)",86,5,0,5,20,0,20,0.232558139534884,0,0.232558139534884
"1357","JDB Robertson (ENG)",881,26,1,27,104,6,110,0.118047673098751,0.00681044267877412,0.124858115777526
"1358","JDC Goddard (WI)",859,42,1,43,168,6,174,0.19557625145518,0.0069848661233993,0.20256111757858
"1359","JDF Larter (ENG)",16,1,0,1,4,0,4,0.25,0,0.25
"1360","JDP Oram (NZ)",1780,209,21,230,836,126,962,0.469662921348315,0.0707865168539326,0.540449438202247
"1361","JDS Neesham (NZ)",709,88,11,99,352,66,418,0.496473906911142,0.0930888575458392,0.589562764456982
"1362","JE Barrett (AUS)",80,0,0,0,0,0,0,0,0,0
"1363","JE Benjamin (ENG)",0,0,0,0,0,0,0,NA,NA,NA
"1364","JE Cheetham (SA)",883,52,3,55,208,18,226,0.235560588901472,0.0203850509626274,0.2559456398641
"1365","JE Emburey (ENG)",1713,195,6,201,780,36,816,0.455341506129597,0.021015761821366,0.476357267950963
"1366","JE McConnon (ENG)",18,0,0,0,0,0,0,0,0,0
"1367","JE Mills (NZ)",241,12,0,12,48,0,48,0.199170124481328,0,0.199170124481328
"1368","JE Morris (ENG)",71,6,0,6,24,0,24,0.338028169014085,0,0.338028169014085
"1369","JE Pothecary (SA)",26,2,0,2,8,0,8,0.307692307692308,0,0.307692307692308
"1370","JE Root (ENG)",6154,704,16,720,2816,96,2912,0.457588560285993,0.0155996100097498,0.473188170295743
"1371","JE Taylor (WI)",856,116,19,135,464,114,578,0.542056074766355,0.133177570093458,0.675233644859813
"1372","JEC Franklin (NZ)",808,82,5,87,328,30,358,0.405940594059406,0.0371287128712871,0.443069306930693
"1373","JED Sealy (WI)",478,13,3,16,52,18,70,0.108786610878661,0.0376569037656904,0.146443514644351
"1374","JEF Beck (NZ)",394,37,2,39,148,12,160,0.375634517766497,0.0304568527918782,0.406091370558376
"1375","JEP McMaster (ENG)",0,0,0,0,0,0,0,NA,NA,NA
"1376","JER Gallian (ENG)",74,8,0,8,32,0,32,0.432432432432432,0,0.432432432432432
"1377","JF Crapp (ENG)",319,6,1,7,24,6,30,0.0752351097178683,0.0188087774294671,0.0940438871473354
"1378","JF du Toit (SA)",2,0,0,0,0,0,0,0,0,0
"1379","JF Reid (NZ)",1342,137,1,138,548,6,554,0.408345752608048,0.00447093889716841,0.412816691505216
"1380","JFM Morrison (NZ)",656,61,2,63,244,12,256,0.371951219512195,0.0182926829268293,0.390243902439024
"1381","JFW Nicolson (SA)",179,0,0,0,0,0,0,0,0,0
"1382","JG Binks (ENG)",91,7,0,7,28,0,28,0.307692307692308,0,0.307692307692308
"1383","JG Bracewell (NZ)",1001,82,4,86,328,24,352,0.327672327672328,0.023976023976024,0.351648351648352
"1384","JG Dewes (ENG)",121,10,0,10,40,0,40,0.330578512396694,0,0.330578512396694
"1385","JG Leggat (NZ)",351,9,0,9,36,0,36,0.102564102564103,0,0.102564102564103
"1386","JG Navle (INDIA)",42,0,0,0,0,0,0,0,0,0
"1387","JG Thomas (ENG)",83,7,1,8,28,6,34,0.337349397590361,0.072289156626506,0.409638554216867
"1388","JG Wright (NZ)",5334,628,10,638,2512,60,2572,0.470941132358455,0.0112485939257593,0.482189726284214
"1389","JH Anderson (SA)",43,0,1,1,0,6,6,0,0.13953488372093,0.13953488372093
"1390","JH Board (ENG)",108,4,0,4,16,0,16,0.148148148148148,0,0.148148148148148
"1391","JH Cameron (WI)",6,0,0,0,0,0,0,0,0,0
"1392","JH Childs (ENG)",2,0,0,0,0,0,0,0,0,0
"1393","JH de Courcy (AUS)",81,8,2,10,32,12,44,0.395061728395062,0.148148148148148,0.54320987654321
"1394","JH du Preez (SA)",0,0,0,0,0,0,0,NA,NA,NA
"1395","JH Edrich (ENG)",5138,557,11,568,2228,66,2294,0.433631763332036,0.0128454651615415,0.446477228493577
"1396","JH Hampshire (ENG)",403,55,0,55,220,0,220,0.54590570719603,0,0.54590570719603
"1397","JH Kallis (ICC)",83,11,1,12,44,6,50,0.530120481927711,0.072289156626506,0.602409638554217
"1398","JH Kallis (SA)",13206,1477,96,1573,5908,576,6484,0.447372406481902,0.0436165379373012,0.490988944419203
"1399","JH King (ENG)",68,0,0,0,0,0,0,0,0,0
"1400","JH Parks (ENG)",29,0,0,0,0,0,0,0,0,0
"1401","JH Sinclair (SA)",1069,42,16,58,168,96,264,0.157156220767072,0.0898035547240412,0.246959775491113
"1402","JH Wardle (ENG)",653,53,14,67,212,84,296,0.324655436447167,0.128637059724349,0.453292496171516
"1403","JHB Waite (SA)",2405,137,1,138,548,6,554,0.227858627858628,0.00249480249480249,0.23035343035343
"1404","JHW Fingleton (AUS)",1189,53,1,54,212,6,218,0.178301093355761,0.00504625735912532,0.183347350714886
"1405","JJ Bumrah (INDIA)",10,0,0,0,0,0,0,0,0,0
"1406","JJ Crowe (NZ)",1601,183,4,187,732,24,756,0.457214241099313,0.0149906308557152,0.472204871955028
"1407","JJ Ferris (AUS)",98,1,0,1,4,0,4,0.0408163265306122,0,0.0408163265306122
"1408","JJ Ferris (ENG)",16,0,0,0,0,0,0,0,0,0
"1409","JJ Kelly (AUS)",664,23,0,23,92,0,92,0.13855421686747,0,0.13855421686747
"1410","JJ Kotze (SA)",2,0,0,0,0,0,0,0,0,0
"1411","JJ Krejza (AUS)",71,8,0,8,32,0,32,0.450704225352113,0,0.450704225352113
"1412","JJ Lyons (AUS)",731,34,4,38,136,24,160,0.186046511627907,0.0328317373461012,0.218878248974008
"1413","JJ Warr (ENG)",4,0,0,0,0,0,0,0,0,0
"1414","JJ Whitaker (ENG)",11,1,0,1,4,0,4,0.363636363636364,0,0.363636363636364
"1415","JJC Lawson (WI)",52,6,0,6,24,0,24,0.461538461538462,0,0.461538461538462
"1416","JK Irani (INDIA)",3,0,0,0,0,0,0,0,0,0
"1417","JK Lever (ENG)",306,26,1,27,104,6,110,0.339869281045752,0.0196078431372549,0.359477124183007
"1418","JK Moss (AUS)",60,4,1,5,16,6,22,0.266666666666667,0.1,0.366666666666667
"1419","JK Silva (SL)",2058,236,2,238,944,12,956,0.458697764820214,0.00583090379008746,0.464528668610301
"1420","JKC Holt (WI)",1066,57,1,58,228,6,234,0.213883677298311,0.00562851782363977,0.219512195121951
"1421","JL Cox (SA)",21,0,0,0,0,0,0,0,0,0
"1422","JL Hendriks (WI)",447,35,1,36,140,6,146,0.313199105145414,0.0134228187919463,0.32662192393736
"1423","JL Hopwood (ENG)",12,0,0,0,0,0,0,0,0,0
"1424","JL Kerr (NZ)",212,8,0,8,32,0,32,0.150943396226415,0,0.150943396226415
"1425","JL Langer (AUS)",7650,904,39,943,3616,234,3850,0.472679738562092,0.0305882352941176,0.503267973856209
"1426","JL Ontong (SA)",57,8,0,8,32,0,32,0.56140350877193,0,0.56140350877193
"1427","JL Pattinson (AUS)",332,38,3,41,152,18,170,0.457831325301205,0.0542168674698795,0.512048192771084
"1428","JM Anderson (ENG)",1150,154,3,157,616,18,634,0.535652173913043,0.0156521739130435,0.551304347826087
"1429","JM Bairstow (ENG)",3553,416,22,438,1664,132,1796,0.468336616943428,0.0371517027863777,0.505488319729806
"1430","JM Bird (AUS)",43,3,1,4,12,6,18,0.27906976744186,0.13953488372093,0.418604651162791
"1431","JM Blackham (AUS)",800,48,0,48,192,0,192,0.24,0,0.24
"1432","JM Blanckenberg (SA)",451,16,4,20,64,24,88,0.141906873614191,0.0532150776053215,0.195121951219512
"1433","JM Brearley (ENG)",1442,131,0,131,524,0,524,0.363384188626907,0,0.363384188626907
"1434","JM Ghorpade (INDIA)",229,12,0,12,48,0,48,0.209606986899563,0,0.209606986899563
"1435","JM Gregory (AUS)",1146,130,3,133,520,18,538,0.453752181500873,0.0157068062827225,0.469458987783595
"1436","JM Holland (AUS)",1,0,0,0,0,0,0,0,0,0
"1437","JM How (NZ)",772,104,2,106,416,12,428,0.538860103626943,0.0155440414507772,0.55440414507772
"1438","JM Kemp (SA)",80,11,0,11,44,0,44,0.55,0,0.55
"1439","JM Mennie (AUS)",10,2,0,2,8,0,8,0.8,0,0.8
"1440","JM Neblett (WI)",16,0,0,0,0,0,0,0,0,0
"1441","JM Noreiga (WI)",11,0,0,0,0,0,0,0,0,0
"1442","JM Parker (NZ)",1498,121,0,121,484,0,484,0.323097463284379,0,0.323097463284379
"1443","JM Parks (ENG)",1962,146,15,161,584,90,674,0.297655453618756,0.0458715596330275,0.343527013251784
"1444","JM Patel (INDIA)",25,0,0,0,0,0,0,0,0,0
"1445","JM Read (ENG)",461,39,1,40,156,6,162,0.338394793926247,0.0130151843817787,0.351409978308026
"1446","JM Sims (ENG)",16,0,0,0,0,0,0,0,0,0
"1447","JM Taylor (AUS)",981,87,0,87,348,0,348,0.35474006116208,0,0.35474006116208
"1448","JM Vince (ENG)",548,86,0,86,344,0,344,0.627737226277372,0,0.627737226277372
"1449","JM Wiener (AUS)",281,23,3,26,92,18,110,0.327402135231317,0.0640569395017794,0.391459074733096
"1450","JMM Commaille (SA)",351,0,0,0,0,0,0,0,0,0
"1451","JN Crawford (ENG)",469,50,1,51,200,6,206,0.426439232409382,0.0127931769722814,0.439232409381663
"1452","JN Gillespie (AUS)",1172,138,8,146,552,48,600,0.47098976109215,0.0409556313993174,0.511945392491468
"1453","JN Maguire (AUS)",28,4,0,4,16,0,16,0.571428571428571,0,0.571428571428571
"1454","JN Rhodes (SA)",2486,253,21,274,1012,126,1138,0.407079646017699,0.0506838294448914,0.45776347546259
"1455","JN Shepherd (WI)",77,9,1,10,36,6,42,0.467532467532468,0.0779220779220779,0.545454545454545
"1456","JO Holder (WI)",1483,171,24,195,684,144,828,0.461227242076871,0.0971004720161834,0.558327714093055
"1457","JO Taylor (WI)",4,0,0,0,0,0,0,0,0,0
"1458","JP Agnew (ENG)",10,0,0,0,0,0,0,0,0,0
"1459","JP Crawley (ENG)",1800,187,3,190,748,18,766,0.415555555555556,0.01,0.425555555555556
"1460","JP Duminy (SA)",2129,250,13,263,1000,78,1078,0.469704086425552,0.036636918741193,0.506341005166745
"1461","JP Faulkner (AUS)",45,4,1,5,16,6,22,0.355555555555556,0.133333333333333,0.488888888888889
"1462","JP Fellows-Smith (SA)",166,14,0,14,56,0,56,0.337349397590361,0,0.337349397590361
"1463","JP Stephenson (ENG)",36,3,0,3,12,0,12,0.333333333333333,0,0.333333333333333
"1464","JP Taylor (ENG)",34,3,0,3,12,0,12,0.352941176470588,0,0.352941176470588
"1465","JPF Travers (AUS)",10,0,0,0,0,0,0,0,0,0
"1466","JR Gunn (ENG)",85,8,0,8,32,0,32,0.376470588235294,0,0.376470588235294
"1467","JR Hammond (AUS)",28,3,0,3,12,0,12,0.428571428571429,0,0.428571428571429
"1468","JR Hazlewood (AUS)",337,48,2,50,192,12,204,0.56973293768546,0.0356083086053412,0.605341246290801
"1469","JR Hodges (AUS)",10,1,0,1,4,0,4,0.4,0,0.4
"1470","JR Mason (ENG)",129,3,0,3,12,0,12,0.0930232558139535,0,0.0930232558139535
"1471","JR Murray (WI)",918,102,6,108,408,36,444,0.444444444444444,0.0392156862745098,0.483660130718954
"1472","JR Ratnayeke (SL)",807,70,1,71,280,6,286,0.346964064436183,0.00743494423791822,0.354399008674102
"1473","JR Reid (NZ)",3428,374,33,407,1496,198,1694,0.436406067677946,0.0577596266044341,0.49416569428238
"1474","JR Thomson (AUS)",679,68,9,77,272,54,326,0.400589101620029,0.0795287187039764,0.480117820324006
"1475","JR Watkins (AUS)",39,0,0,0,0,0,0,0,0,0
"1476","JRF Duncan (AUS)",3,0,0,0,0,0,0,0,0,0
"1477","JS Foster (ENG)",226,27,1,28,108,6,114,0.47787610619469,0.0265486725663717,0.504424778761062
"1478","JS Patel (NZ)",381,44,3,47,176,18,194,0.461942257217848,0.047244094488189,0.509186351706037
"1479","JS Solomon (WI)",1326,41,1,42,164,6,170,0.1236802413273,0.00452488687782805,0.128205128205128
"1480","JSE Price (ENG)",66,6,0,6,24,0,24,0.363636363636364,0,0.363636363636364
"1481","JT Ball (ENG)",67,8,1,9,32,6,38,0.477611940298507,0.0895522388059701,0.567164179104478
"1482","JT Botten (SA)",65,3,0,3,12,0,12,0.184615384615385,0,0.184615384615385
"1483","JT Brown (ENG)",470,27,0,27,108,0,108,0.229787234042553,0,0.229787234042553
"1484","JT Cottam (AUS)",4,0,0,0,0,0,0,0,0,0
"1485","JT Hearne (ENG)",126,1,2,3,4,12,16,0.0317460317460317,0.0952380952380952,0.126984126984127
"1486","JT Ikin (ENG)",606,38,0,38,152,0,152,0.250825082508251,0,0.250825082508251
"1487","JT Murray (ENG)",506,43,2,45,172,12,184,0.339920948616601,0.0237154150197628,0.363636363636364
"1488","JT Partridge (SA)",73,4,0,4,16,0,16,0.219178082191781,0,0.219178082191781
"1489","JT Sparling (NZ)",229,3,0,3,12,0,12,0.0524017467248908,0,0.0524017467248908
"1490","JT Tyldesley (ENG)",1661,123,3,126,492,18,510,0.296207104154124,0.0108368452739314,0.307043949428055
"1491","JT Ward (NZ)",75,9,0,9,36,0,36,0.48,0,0.48
"1492","JT Willoughby (SA)",8,0,0,0,0,0,0,0,0,0
"1493","JTC Vaughan (NZ)",201,21,0,21,84,0,84,0.417910447761194,0,0.417910447761194
"1494","Jubair Hossain (BDESH)",13,1,0,1,4,0,4,0.307692307692308,0,0.307692307692308
"1495","Junaid Khan (PAK)",122,14,2,16,56,12,68,0.459016393442623,0.0983606557377049,0.557377049180328
"1496","Junaid Siddique (BDESH)",969,123,1,124,492,6,498,0.507739938080495,0.00619195046439629,0.513931888544892
"1497","JV Coney (NZ)",2668,266,8,274,1064,48,1112,0.39880059970015,0.0179910044977511,0.416791604197901
"1498","JV Saunders (AUS)",39,2,0,2,8,0,8,0.205128205128205,0,0.205128205128205
"1499","JW Burke (AUS)",1280,67,0,67,268,0,268,0.209375,0,0.209375
"1500","JW D'Arcy (NZ)",136,5,0,5,20,0,20,0.147058823529412,0,0.147058823529412
"1501","JW Gleeson (AUS)",395,39,0,39,156,0,156,0.394936708860759,0,0.394936708860759
"1502","JW Guy (NZ)",440,35,0,35,140,0,140,0.318181818181818,0,0.318181818181818
"1503","JW Hastings (AUS)",52,5,2,7,20,12,32,0.384615384615385,0.230769230769231,0.615384615384615
"1504","JW Hearne (ENG)",810,42,0,42,168,0,168,0.207407407407407,0,0.207407407407407
"1505","JW Hitch (ENG)",115,12,1,13,48,6,54,0.417391304347826,0.0521739130434783,0.469565217391304
"1506","JW Martin (AUS)",214,23,3,26,92,18,110,0.429906542056075,0.0841121495327103,0.514018691588785
"1507","JW Martin (ENG)",26,0,2,2,0,12,12,0,0.461538461538462,0.461538461538462
"1508","JW McLaren (AUS)",0,0,0,0,0,0,0,NA,NA,NA
"1509","JW Rutherford (AUS)",30,0,0,0,0,0,0,0,0,0
"1510","JW Sharpe (ENG)",44,0,0,0,0,0,0,0,0,0
"1511","JW Trumble (AUS)",243,13,0,13,52,0,52,0.213991769547325,0,0.213991769547325
"1512","JW Zulch (SA)",983,54,1,55,216,6,222,0.219735503560529,0.00610376398779247,0.225839267548321
"1513","JWA Taylor (ENG)",312,32,2,34,128,12,140,0.41025641025641,0.0384615384615385,0.448717948717949
"1514","JWH Makepeace (ENG)",271,12,0,12,48,0,48,0.177121771217712,0,0.177121771217712
"1515","JWHT Douglas (ENG)",962,51,0,51,204,0,204,0.212058212058212,0,0.212058212058212
"1516","K Cranston (ENG)",209,0,0,0,0,0,0,0,0,0
"1517","K Farnes (ENG)",58,2,0,2,8,0,8,0.137931034482759,0,0.137931034482759
"1518","K Higgs (ENG)",185,15,3,18,60,18,78,0.324324324324324,0.0972972972972973,0.421621621621622
"1519","K Rabada (SA)",431,59,4,63,236,24,260,0.547563805104408,0.0556844547563805,0.603248259860789
"1520","K Rai Singh (INDIA)",26,1,1,2,4,6,10,0.153846153846154,0.230769230769231,0.384615384615385
"1521","K Shuttleworth (ENG)",46,5,0,5,20,0,20,0.434782608695652,0,0.434782608695652
"1522","K Srikkanth (INDIA)",2062,221,19,240,884,114,998,0.428709990300679,0.055286129970902,0.483996120271581
"1523","K Taylor (ENG)",57,5,0,5,20,0,20,0.350877192982456,0,0.350877192982456
"1524","K Thomson (NZ)",94,5,1,6,20,6,26,0.212765957446809,0.0638297872340425,0.276595744680851
"1525","KA Archer (AUS)",234,17,0,17,68,0,68,0.290598290598291,0,0.290598290598291
"1526","KA Edwards (WI)",986,111,12,123,444,72,516,0.450304259634888,0.0730223123732252,0.523326572008114
"1527","KA Hope (WI)",101,14,0,14,56,0,56,0.554455445544555,0,0.554455445544555
"1528","KA Maharaj (SA)",403,43,13,56,172,78,250,0.426799007444169,0.193548387096774,0.620347394540943
"1529","KA Walter (SA)",11,0,0,0,0,0,0,0,0,0
"1530","Kabir Ali (ENG)",10,1,0,1,4,0,4,0.4,0,0.4
"1531","Kabir Khan (PAK)",24,3,0,3,12,0,12,0.5,0,0.5
"1532","KADM Fernando (SL)",56,8,0,8,32,0,32,0.571428571428571,0,0.571428571428571
"1533","KAJ Roach (WI)",735,85,4,89,340,24,364,0.462585034013605,0.0326530612244898,0.495238095238095
"1534","Kamran Akmal (PAK)",2648,372,14,386,1488,84,1572,0.561933534743202,0.0317220543806647,0.593655589123867
"1535","Kamrul Islam Rabbi (BDESH)",51,5,2,7,20,12,32,0.392156862745098,0.235294117647059,0.627450980392157
"1536","KBJ Azad (INDIA)",135,13,0,13,52,0,52,0.385185185185185,0,0.385185185185185
"1537","KC Bland (SA)",1669,137,20,157,548,120,668,0.328340323547034,0.0718993409227082,0.400239664469742
"1538","KC Brathwaite (WI)",3263,313,9,322,1252,54,1306,0.383695985289611,0.0165491878639289,0.40024517315354
"1539","KC Ibrahim (INDIA)",169,9,1,10,36,6,42,0.21301775147929,0.0355029585798817,0.248520710059172
"1540","KC James (NZ)",52,0,0,0,0,0,0,0,0,0
"1541","KC Sangakkara (SL)",12400,1491,51,1542,5964,306,6270,0.480967741935484,0.0246774193548387,0.505645161290323
"1542","KC Wessels (AUS)",1807,200,2,202,800,12,812,0.442722744881018,0.00664084117321527,0.449363586054234
"1543","KC Wessels (SA)",1027,107,1,108,428,6,434,0.416747809152872,0.00584225900681597,0.422590068159688
"1544","KCG Benjamin (WI)",222,28,1,29,112,6,118,0.504504504504504,0.027027027027027,0.531531531531532
"1545","KD Boyce (WI)",657,79,5,84,316,30,346,0.480974124809741,0.045662100456621,0.526636225266362
"1546","KD Ghavri (INDIA)",913,73,7,80,292,42,334,0.319824753559693,0.0460021905805038,0.365826944140197
"1547","KD Karthik (INDIA)",1025,134,4,138,536,24,560,0.522926829268293,0.0234146341463415,0.546341463414634
"1548","KD Mackay (AUS)",1507,64,2,66,256,12,268,0.169873921698739,0.0079628400796284,0.177836761778368
"1549","KD Meuleman (AUS)",0,0,0,0,0,0,0,NA,NA,NA
"1550","KD Mills (NZ)",289,37,3,40,148,18,166,0.512110726643599,0.0622837370242214,0.57439446366782
"1551","KD Walters (AUS)",5357,525,23,548,2100,138,2238,0.392010453612096,0.025760686951652,0.417771140563748
"1552","KDK Vithanage (SL)",370,44,9,53,176,54,230,0.475675675675676,0.145945945945946,0.621621621621622
"1553","KE Palmer (ENG)",10,1,0,1,4,0,4,0.4,0,0.4
"1554","KE Rigg (AUS)",401,28,0,28,112,0,112,0.27930174563591,0,0.27930174563591
"1555","KEA Upashantha (SL)",10,1,0,1,4,0,4,0.4,0,0.4
"1556","KF Barrington (ENG)",6806,618,27,645,2472,162,2634,0.363208933294152,0.0238025271818983,0.387011460476051
"1557","KG Viljoen (SA)",1365,52,0,52,208,0,208,0.152380952380952,0,0.152380952380952
"1558","KH Eastwood (AUS)",5,0,0,0,0,0,0,0,0,0
"1559","KH Weekes (WI)",173,18,1,19,72,6,78,0.416184971098266,0.0346820809248555,0.450867052023121
"1560","Khaled Mahmud (BDESH)",266,30,3,33,120,18,138,0.451127819548872,0.0676691729323308,0.518796992481203
"1561","Khaled Mashud (BDESH)",1409,147,1,148,588,6,594,0.417317246273953,0.0042583392476934,0.421575585521647
"1562","Khalid Hasan (PAK)",17,3,0,3,12,0,12,0.705882352941177,0,0.705882352941177
"1563","Khalid Ibadulla (PAK)",253,26,0,26,104,0,104,0.411067193675889,0,0.411067193675889
"1564","Khalid Wazir (PAK)",14,1,0,1,4,0,4,0.285714285714286,0,0.285714285714286
"1565","Khan Mohammad (PAK)",100,3,0,3,12,0,12,0.12,0,0.12
"1566","KHRK Fernando (SL)",38,8,0,8,32,0,32,0.842105263157895,0,0.842105263157895
"1567","Khurram Manzoor (PAK)",817,100,1,101,400,6,406,0.489596083231334,0.00734394124847001,0.496940024479804
"1568","KIW Wijegunawardene (SL)",14,1,0,1,4,0,4,0.285714285714286,0,0.285714285714286
"1569","KJ Abbott (SA)",95,10,1,11,40,6,46,0.421052631578947,0.0631578947368421,0.484210526315789
"1570","KJ Arnott (ZIM)",302,30,1,31,120,6,126,0.397350993377483,0.0198675496688742,0.417218543046358
"1571","KJ Barnett (ENG)",207,28,0,28,112,0,112,0.541062801932367,0,0.541062801932367
"1572","KJ Funston (SA)",824,32,3,35,128,18,146,0.155339805825243,0.0218446601941748,0.177184466019417
"1573","KJ Hughes (AUS)",4415,444,27,471,1776,162,1938,0.402265005662514,0.0366930917327293,0.438958097395243
"1574","KJ O'Brien (IRE)",158,17,0,17,68,0,68,0.430379746835443,0,0.430379746835443
"1575","KJ O'Keeffe (AUS)",644,53,1,54,212,6,218,0.329192546583851,0.0093167701863354,0.338509316770186
"1576","KJ Silva (SL)",6,1,0,1,4,0,4,0.666666666666667,0,0.666666666666667
"1577","KJ Wadsworth (NZ)",1010,99,1,100,396,6,402,0.392079207920792,0.00594059405940594,0.398019801980198
"1578","KJ Wright (AUS)",219,21,0,21,84,0,84,0.383561643835616,0,0.383561643835616
"1579","KK Jennings (ENG)",476,64,0,64,256,0,256,0.53781512605042,0,0.53781512605042
"1580","KK Nair (INDIA)",374,41,4,45,164,24,188,0.438502673796791,0.0641711229946524,0.502673796791444
"1581","KK Peters (WI)",0,0,0,0,0,0,0,NA,NA,NA
"1582","KK Tarapore (INDIA)",2,0,0,0,0,0,0,0,0,0
"1583","KL Hutchings (ENG)",341,33,1,34,132,6,138,0.387096774193548,0.0175953079178886,0.404692082111437
"1584","KL Rahul (INDIA)",1625,195,11,206,780,66,846,0.48,0.0406153846153846,0.520615384615385
"1585","KL Wishart (WI)",52,0,0,0,0,0,0,0,0,0
"1586","KLT Arthurton (WI)",1382,145,17,162,580,102,682,0.419681620839363,0.0738060781476122,0.493487698986975
"1587","KM Dabengwa (ZIM)",90,14,2,16,56,12,68,0.622222222222222,0.133333333333333,0.755555555555556
"1588","KM Jarvis (ZIM)",111,13,1,14,52,6,58,0.468468468468468,0.0540540540540541,0.522522522522523
"1589","KM Rangnekar (INDIA)",33,4,0,4,16,0,16,0.484848484848485,0,0.484848484848485
"1590","KMA Paul (WI)",13,1,1,2,4,6,10,0.307692307692308,0.461538461538462,0.769230769230769
"1591","KMDN Kulasekara (SL)",391,47,8,55,188,48,236,0.480818414322251,0.122762148337596,0.603580562659846
"1592","KN Amalean (SL)",9,1,0,1,4,0,4,0.444444444444444,0,0.444444444444444
"1593","KN Slater (AUS)",1,0,0,0,0,0,0,0,0,0
"1594","KO Meth (ZIM)",72,7,2,9,28,12,40,0.388888888888889,0.166666666666667,0.555555555555556
"1595","KOA Powell (WI)",1881,247,12,259,988,72,1060,0.525252525252525,0.0382775119617225,0.563530037214248
"1596","KP Pietersen (ENG)",8181,985,81,1066,3940,486,4426,0.481603715927148,0.0594059405940594,0.541009656521208
"1597","KP Walmsley (NZ)",13,2,0,2,8,0,8,0.615384615384615,0,0.615384615384615
"1598","KPJ Warnaweera (SL)",39,4,0,4,16,0,16,0.41025641025641,0,0.41025641025641
"1599","KR Meherhomji (INDIA)",0,0,0,0,0,0,0,NA,NA,NA
"1600","KR Miller (AUS)",2958,222,28,250,888,168,1056,0.300202839756592,0.0567951318458418,0.356997971602434
"1601","KR Pushpakumara (SL)",166,19,4,23,76,24,100,0.457831325301205,0.144578313253012,0.602409638554217
"1602","KR Rickards (WI)",104,1,0,1,4,0,4,0.0384615384615385,0,0.0384615384615385
"1603","KR Rutherford (NZ)",2465,314,15,329,1256,90,1346,0.509533468559838,0.0365111561866126,0.54604462474645
"1604","KR Stackpole (AUS)",2807,318,10,328,1272,60,1332,0.453152832205201,0.021375133594585,0.474527965799786
"1605","KS Duleepsinhji (ENG)",995,64,1,65,256,6,262,0.257286432160804,0.00603015075376884,0.263316582914573
"1606","KS Indrajitsinhji (INDIA)",51,5,0,5,20,0,20,0.392156862745098,0,0.392156862745098
"1607","KS Lokuarachchi (SL)",94,14,1,15,56,6,62,0.595744680851064,0.0638297872340425,0.659574468085106
"1608","KS More (INDIA)",1331,139,2,141,556,12,568,0.417731029301277,0.00901577761081893,0.426746806912096
"1609","KS Ranjitsinhji (ENG)",989,79,0,79,316,0,316,0.319514661274014,0,0.319514661274014
"1610","KS Williamson (NZ)",5338,585,13,598,2340,78,2418,0.438366429374297,0.0146122143124766,0.452978643686774
"1611","KSC de Silva (SL)",65,9,1,10,36,6,42,0.553846153846154,0.0923076923076923,0.646153846153846
"1612","KTGD Prasad (SL)",476,53,8,61,212,48,260,0.445378151260504,0.100840336134454,0.546218487394958
"1613","Kuldeep Yadav (INDIA)",33,3,0,3,12,0,12,0.363636363636364,0,0.363636363636364
"1614","KV Andrew (ENG)",29,3,0,3,12,0,12,0.413793103448276,0,0.413793103448276
"1615","KV Sharma (INDIA)",8,0,0,0,0,0,0,0,0,0
"1616","KW Hough (NZ)",62,8,1,9,32,6,38,0.516129032258065,0.0967741935483871,0.612903225806452
"1617","KWR Fletcher (ENG)",3272,355,6,361,1420,36,1456,0.43398533007335,0.0110024449877751,0.444987775061125
"1618","L Amar Singh (INDIA)",292,7,2,9,28,12,40,0.0958904109589041,0.0410958904109589,0.136986301369863
"1619","L Amarnath (INDIA)",878,39,0,39,156,0,156,0.177676537585421,0,0.177676537585421
"1620","L Baichan (WI)",184,1,0,1,4,0,4,0.0217391304347826,0,0.0217391304347826
"1621","L Balaji (INDIA)",51,5,1,6,20,6,26,0.392156862745098,0.117647058823529,0.509803921568627
"1622","L Hone (ENG)",13,0,0,0,0,0,0,0,0,0
"1623","L Hutton (ENG)",6971,475,7,482,1900,42,1942,0.272557739205279,0.00602496055085354,0.278582699756133
"1624","L Klusener (SA)",1906,236,20,256,944,120,1064,0.495278069254984,0.0629590766002099,0.558237145855194
"1625","L Ngidi (SA)",15,3,0,3,12,0,12,0.8,0,0.8
"1626","L Ramji (INDIA)",1,0,0,0,0,0,0,0,0,0
"1627","L Ronchi (NZ)",319,41,6,47,164,36,200,0.5141065830721,0.112852664576803,0.626959247648903
"1628","L Sivaramakrishnan (INDIA)",130,8,0,8,32,0,32,0.246153846153846,0,0.246153846153846
"1629","L Tuckett (SA)",131,0,0,0,0,0,0,0,0,0
"1630","L Vincent (NZ)",1332,161,12,173,644,72,716,0.483483483483483,0.0540540540540541,0.537537537537538
"1631","L Watt (NZ)",2,0,0,0,0,0,0,0,0,0
"1632","LA Butterfield (NZ)",0,0,0,0,0,0,0,NA,NA,NA
"1633","LA Dawson (ENG)",84,7,1,8,28,6,34,0.333333333333333,0.0714285714285714,0.404761904761905
"1634","LA King (WI)",41,4,1,5,16,6,22,0.390243902439024,0.146341463414634,0.536585365853659
"1635","LA Markham (SA)",20,0,0,0,0,0,0,0,0,0
"1636","LA Roberts (WI)",0,0,0,0,0,0,0,NA,NA,NA
"1637","LA Stricker (SA)",352,21,0,21,84,0,84,0.238636363636364,0,0.238636363636364
"1638","LA Walcott (WI)",40,0,0,0,0,0,0,0,0,0
"1639","Lall Singh (INDIA)",44,0,0,0,0,0,0,0,0,0
"1640","LB Fishlock (ENG)",47,1,0,1,4,0,4,0.0851063829787234,0,0.0851063829787234
"1641","LB Taylor (ENG)",1,0,0,0,0,0,0,0,0,0
"1642","LC Braund (ENG)",987,93,2,95,372,12,384,0.376899696048632,0.0121580547112462,0.389057750759878
"1643","LC Mayne (AUS)",76,3,0,3,12,0,12,0.157894736842105,0,0.157894736842105
"1644","LCH Palairet (ENG)",49,0,0,0,0,0,0,0,0,0
"1645","LD Chandimal (SL)",3642,389,22,411,1556,132,1688,0.42723778143877,0.0362438220757825,0.463481603514552
"1646","LE Favell (AUS)",757,48,2,50,192,12,204,0.253632760898283,0.0158520475561427,0.269484808454425
"1647","LE Nagel (AUS)",21,4,0,4,16,0,16,0.761904761904762,0,0.761904761904762
"1648","LE Plunkett (ENG)",238,31,0,31,124,0,124,0.521008403361345,0,0.521008403361345
"1649","LE Tapscott (SA)",58,0,1,1,0,6,6,0,0.103448275862069,0.103448275862069
"1650","LEG Ames (ENG)",2434,172,6,178,688,36,724,0.28266228430567,0.0147904683648316,0.297452752670501
"1651","LF Kline (AUS)",58,2,0,2,8,0,8,0.137931034482759,0,0.137931034482759
"1652","LF Townsend (ENG)",97,0,1,1,0,6,6,0,0.0618556701030928,0.0618556701030928
"1653","LG Hylton (WI)",70,0,1,1,0,6,6,0,0.0857142857142857,0.0857142857142857
"1654","LG Rowe (WI)",2047,210,6,216,840,36,876,0.410356619443087,0.0175867122618466,0.427943331704934
"1655","LH Gay (ENG)",37,3,0,3,12,0,12,0.324324324324324,0,0.324324324324324
"1656","Liaqat Ali (PAK)",28,2,0,2,8,0,8,0.285714285714286,0,0.285714285714286
"1657","Liton Das (BDESH)",457,63,1,64,252,6,258,0.551422319474836,0.0131291028446389,0.564551422319475
"1658","LJ Coldwell (ENG)",9,1,0,1,4,0,4,0.444444444444444,0,0.444444444444444
"1659","LJ Johnson (AUS)",25,1,0,1,4,0,4,0.16,0,0.16
"1660","LJ Moon (ENG)",182,19,1,20,76,6,82,0.417582417582418,0.032967032967033,0.450549450549451
"1661","LJ Nash (AUS)",30,1,0,1,4,0,4,0.133333333333333,0,0.133333333333333
"1662","LJ Tancred (SA)",530,27,1,28,108,6,114,0.20377358490566,0.0113207547169811,0.215094339622642
"1663","LK Germon (NZ)",382,54,1,55,216,6,222,0.565445026178011,0.0157068062827225,0.581151832460733
"1664","LL Tsotsobe (SA)",19,2,0,2,8,0,8,0.421052631578947,0,0.421052631578947
"1665","LL Wilkinson (ENG)",3,0,0,0,0,0,0,0,0,0
"1666","LMP Simmons (WI)",278,28,4,32,112,24,136,0.402877697841727,0.0863309352517986,0.489208633093525
"1667","LN Constantine (WI)",635,16,10,26,64,60,124,0.100787401574803,0.094488188976378,0.195275590551181
"1668","LO Fleetwood-Smith (AUS)",54,5,1,6,20,6,26,0.37037037037037,0.111111111111111,0.481481481481481
"1669","Lord Harris (ENG)",145,15,0,15,60,0,60,0.413793103448276,0,0.413793103448276
"1670","Lord Hawke (ENG)",55,0,0,0,0,0,0,0,0,0
"1671","Lord Tennyson (ENG)",345,31,0,31,124,0,124,0.359420289855072,0,0.359420289855072
"1672","LP Jai (INDIA)",19,0,0,0,0,0,0,0,0,0
"1673","LPC Silva (SL)",537,68,1,69,272,6,278,0.506517690875233,0.0111731843575419,0.517690875232775
"1674","LPJ O'Brien (AUS)",211,7,0,7,28,0,28,0.132701421800948,0,0.132701421800948
"1675","LR Gibbs (WI)",488,24,0,24,96,0,96,0.19672131147541,0,0.19672131147541
"1676","LR Johnson (WI)",403,55,1,56,220,6,226,0.54590570719603,0.0148883374689826,0.560794044665012
"1677","LR Joslin (AUS)",9,0,0,0,0,0,0,0,0,0
"1678","LR Tuckett (SA)",0,0,0,0,0,0,0,NA,NA,NA
"1679","LRD Mendis (SL)",1329,106,11,117,424,66,490,0.319036869826938,0.0496613995485327,0.36869826937547
"1680","LRPL Taylor (NZ)",6281,776,44,820,3104,264,3368,0.494188823435759,0.042031523642732,0.536220347078491
"1681","LS Baker (WI)",23,3,0,3,12,0,12,0.521739130434783,0,0.521739130434783
"1682","LS Birkett (WI)",136,8,0,8,32,0,32,0.235294117647059,0,0.235294117647059
"1683","LS Brown (SA)",17,0,0,0,0,0,0,0,0,0
"1684","LS Butler (WI)",16,0,0,0,0,0,0,0,0,0
"1685","LS Darling (AUS)",474,21,0,21,84,0,84,0.177215189873418,0,0.177215189873418
"1686","LS Pascoe (AUS)",106,12,0,12,48,0,48,0.452830188679245,0,0.452830188679245
"1687","LS Rajput (INDIA)",105,0,0,0,0,0,0,0,0,0
"1688","LSM Miller (NZ)",346,3,0,3,12,0,12,0.0346820809248555,0,0.0346820809248555
"1689","LV Garrick (WI)",27,2,0,2,8,0,8,0.296296296296296,0,0.296296296296296
"1690","LV Maddocks (AUS)",177,13,0,13,52,0,52,0.293785310734463,0,0.293785310734463
"1691","LWS Kaluperuma (SL)",12,1,0,1,4,0,4,0.333333333333333,0,0.333333333333333
"1692","M Amarnath (INDIA)",4378,330,21,351,1320,126,1446,0.301507537688442,0.0287802649611695,0.330287802649612
"1693","M Azharuddin (INDIA)",6215,720,19,739,2880,114,2994,0.463395012067578,0.018342719227675,0.481737731295253
"1694","M Baqa Jilani (INDIA)",16,0,0,0,0,0,0,0,0,0
"1695","M Bisset (SA)",107,0,0,0,0,0,0,0,0,0
"1696","M de Lange (SA)",9,2,0,2,8,0,8,0.888888888888889,0,0.888888888888889
"1697","M Dillon (WI)",549,76,7,83,304,42,346,0.553734061930783,0.0765027322404372,0.63023679417122
"1698","M Hayward (SA)",66,10,0,10,40,0,40,0.606060606060606,0,0.606060606060606
"1699","M Henderson (NZ)",8,0,0,0,0,0,0,0,0,0
"1700","M Hendrick (ENG)",128,17,0,17,68,0,68,0.53125,0,0.53125
"1701","M Jahangir Khan (INDIA)",39,0,0,0,0,0,0,0,0,0
"1702","M Kaif (INDIA)",624,64,2,66,256,12,268,0.41025641025641,0.0192307692307692,0.429487179487179
"1703","M Kartik (INDIA)",88,11,0,11,44,0,44,0.5,0,0.5
"1704","M Leyland (ENG)",2764,209,7,216,836,42,878,0.30246020260492,0.0151953690303907,0.317655571635311
"1705","M Mbangwa (ZIM)",34,3,0,3,12,0,12,0.352941176470588,0,0.352941176470588
"1706","M Morkel (SA)",944,143,5,148,572,30,602,0.605932203389831,0.0317796610169492,0.63771186440678
"1707","M Muralitharan (ICC)",2,0,0,0,0,0,0,0,0,0
"1708","M Muralitharan (SL)",1259,146,29,175,584,174,758,0.463860206513106,0.138204924543288,0.602065131056394
"1709","M Ngam (SA)",0,0,0,0,0,0,0,NA,NA,NA
"1710","M Nissar (INDIA)",55,0,0,0,0,0,0,0,0,0
"1711","M Ntini (SA)",699,104,8,112,416,48,464,0.595135908440629,0.0686695278969957,0.663805436337625
"1712","M Prabhakar (INDIA)",1554,162,4,166,648,24,672,0.416988416988417,0.0154440154440154,0.432432432432432
"1713","M Sherwin (ENG)",30,1,0,1,4,0,4,0.133333333333333,0,0.133333333333333
"1714","M van Jaarsveld (SA)",397,56,0,56,224,0,224,0.564231738035264,0,0.564231738035264
"1715","M Venkataramana (INDIA)",0,0,0,0,0,0,0,NA,NA,NA
"1716","M Vijay (INDIA)",3933,463,33,496,1852,198,2050,0.470887363335876,0.0503432494279176,0.521230612763794
"1717","M Watkinson (ENG)",167,18,1,19,72,6,78,0.431137724550898,0.0359281437125748,0.467065868263473
"1718","M Zondeki (SA)",82,12,0,12,48,0,48,0.585365853658537,0,0.585365853658537
"1719","MA Atherton (ENG)",7728,904,4,908,3616,24,3640,0.467908902691511,0.0031055900621118,0.471014492753623
"1720","MA Beer (AUS)",6,0,0,0,0,0,0,0,0,0
"1721","MA Butcher (ENG)",4288,559,3,562,2236,18,2254,0.521455223880597,0.00419776119402985,0.525652985074627
"1722","MA Carberry (ENG)",345,54,1,55,216,6,222,0.626086956521739,0.0173913043478261,0.643478260869565
"1723","MA Ealham (ENG)",210,21,0,21,84,0,84,0.4,0,0.4
"1724","MA Hanley (SA)",0,0,0,0,0,0,0,NA,NA,NA
"1725","MA Holding (WI)",910,78,36,114,312,216,528,0.342857142857143,0.237362637362637,0.58021978021978
"1726","MA Noble (AUS)",1997,106,2,108,424,12,436,0.212318477716575,0.00600901352028042,0.218327491236855
"1727","MA Seymour (SA)",84,7,0,7,28,0,28,0.333333333333333,0,0.333333333333333
"1728","MA Small (WI)",3,0,0,0,0,0,0,0,0,0
"1729","MA Starc (AUS)",1171,117,34,151,468,204,672,0.399658411614005,0.174210076857387,0.573868488471392
"1730","MA Taylor (AUS)",7479,721,9,730,2884,54,2938,0.385613049872978,0.0072202166064982,0.392833266479476
"1731","MA Vermeulen (ZIM)",449,58,2,60,232,12,244,0.516703786191537,0.0267260579064588,0.543429844097996
"1732","MA Wood (ENG)",291,46,2,48,184,12,196,0.632302405498282,0.0412371134020619,0.673539518900344
"1733","Mahbubul Alam (BDESH)",5,0,0,0,0,0,0,0,0,0
"1734","Mahmood Hussain (PAK)",336,18,2,20,72,12,84,0.214285714285714,0.0357142857142857,0.25
"1735","Mahmudullah (BDESH)",2084,247,16,263,988,96,1084,0.474088291746641,0.0460652591170825,0.520153550863724
"1736","Majid Khan (PAK)",3931,379,9,388,1516,54,1570,0.385652505723734,0.0137369626049351,0.39938946832867
"1737","MAK Pataudi (INDIA)",2793,332,19,351,1328,114,1442,0.47547440028643,0.0408163265306122,0.516290726817043
"1738","Maninder Singh (INDIA)",99,5,1,6,20,6,26,0.202020202020202,0.0606060606060606,0.262626262626263
"1739","Manjural Islam (BDESH)",81,6,0,6,24,0,24,0.296296296296296,0,0.296296296296296
"1740","Manjural Islam Rana (BDESH)",257,30,1,31,120,6,126,0.466926070038911,0.0233463035019455,0.490272373540856
"1741","Mansoor Akhtar (PAK)",655,91,1,92,364,6,370,0.555725190839695,0.00916030534351145,0.564885496183206
"1742","Manzoor Elahi (PAK)",123,16,2,18,64,12,76,0.520325203252033,0.0975609756097561,0.617886178861789
"1743","Maqsood Ahmed (PAK)",507,14,3,17,56,18,74,0.110453648915187,0.0355029585798817,0.145956607495069
"1744","MAR Samarasekera (SL)",118,14,1,15,56,6,62,0.474576271186441,0.0508474576271186,0.525423728813559
"1745","Marshall Ayub (BDESH)",125,13,1,14,52,6,58,0.416,0.048,0.464
"1746","Mashrafe Mortaza (BDESH)",797,95,22,117,380,132,512,0.476787954830615,0.165621079046424,0.642409033877039
"1747","Masood Anwar (PAK)",39,1,0,1,4,0,4,0.102564102564103,0,0.102564102564103
"1748","MAWR Madurasinghe (SL)",24,1,0,1,4,0,4,0.166666666666667,0,0.166666666666667
"1749","MB Owens (NZ)",16,2,0,2,8,0,8,0.5,0,0.5
"1750","MB Poore (NZ)",355,10,0,10,40,0,40,0.112676056338028,0,0.112676056338028
"1751","MC Bird (ENG)",288,0,2,2,0,12,12,0,0.0416666666666667,0.0416666666666667
"1752","MC Carew (WI)",1127,104,1,105,416,6,422,0.369121561668146,0.00532386867790594,0.374445430346051
"1753","MC Cowdrey (ENG)",7624,753,13,766,3012,78,3090,0.395068205666317,0.0102308499475341,0.405299055613851
"1754","MC Frederick (WI)",30,0,1,1,0,6,6,0,0.2,0.2
"1755","MC Henriques (AUS)",164,12,2,14,48,12,60,0.292682926829268,0.0731707317073171,0.365853658536585
"1756","MC Ilott (ENG)",28,4,0,4,16,0,16,0.571428571428571,0,0.571428571428571
"1757","MC Snedden (NZ)",327,35,0,35,140,0,140,0.428134556574924,0,0.428134556574924
"1758","MD Bell (NZ)",729,100,0,100,400,0,400,0.548696844993141,0,0.548696844993141
"1759","MD Craig (NZ)",589,65,10,75,260,60,320,0.441426146010187,0.101867572156197,0.543293718166384
"1760","MD Crowe (NZ)",5490,662,27,689,2648,162,2810,0.482331511839709,0.0295081967213115,0.51183970856102
"1761","MD Gunathilaka (SL)",259,29,3,32,116,18,134,0.447876447876448,0.0694980694980695,0.517374517374517
"1762","MD Marshall (WI)",1810,189,18,207,756,108,864,0.41767955801105,0.0596685082872928,0.477348066298343
"1763","MD Moxon (ENG)",455,44,0,44,176,0,176,0.386813186813187,0,0.386813186813187
"1764","MD Shanaka (SL)",29,2,2,4,8,12,20,0.275862068965517,0.413793103448276,0.689655172413793
"1765","MD Stoneman (ENG)",526,66,1,67,264,6,270,0.501901140684411,0.0114068441064639,0.513307984790874
"1766","MD Wettimuny (SL)",28,2,0,2,8,0,8,0.285714285714286,0,0.285714285714286
"1767","MDK Perera (SL)",992,119,20,139,476,120,596,0.479838709677419,0.120967741935484,0.600806451612903
"1768","MDKJ Perera (SL)",657,86,4,90,344,24,368,0.523592085235921,0.0365296803652968,0.560121765601218
"1769","MDUS Jayasundera (SL)",30,2,0,2,8,0,8,0.266666666666667,0,0.266666666666667
"1770","ME Chapple (NZ)",497,35,2,37,140,12,152,0.28169014084507,0.0241448692152917,0.305835010060362
"1771","ME Trescothick (ENG)",5779,822,42,864,3288,252,3540,0.568956566880083,0.0436061602353348,0.612562727115418
"1772","ME Waugh (AUS)",8029,844,41,885,3376,246,3622,0.420475775314485,0.0306389338647403,0.451114709179225
"1773","Mehidy Hasan Miraz (BDESH)",362,39,5,44,156,30,186,0.430939226519337,0.0828729281767956,0.513812154696133
"1774","Mehrab Hossain (BDESH)",241,26,0,26,104,0,104,0.431535269709544,0,0.431535269709544
"1775","Mehrab Hossain jnr (BDESH)",243,32,1,33,128,6,134,0.526748971193416,0.0246913580246914,0.551440329218107
"1776","MEK Hussey (AUS)",6235,685,39,724,2740,234,2974,0.439454691259022,0.0375300721732157,0.476984763432237
"1777","MEZ Ghazali (PAK)",32,3,0,3,12,0,12,0.375,0,0.375
"1778","MF Kent (AUS)",217,28,0,28,112,0,112,0.516129032258065,0,0.516129032258065
"1779","MF Maharoof (SL)",556,67,3,70,268,18,286,0.482014388489209,0.0323741007194245,0.514388489208633
"1780","MF Malone (AUS)",46,6,0,6,24,0,24,0.521739130434783,0,0.521739130434783
"1781","MF Tremlett (ENG)",20,0,1,1,0,6,6,0,0.3,0.3
"1782","MG Bevan (AUS)",785,89,1,90,356,6,362,0.453503184713376,0.00764331210191083,0.461146496815287
"1783","MG Burgess (NZ)",2684,262,17,279,1048,102,1150,0.390461997019374,0.0380029806259314,0.428464977645306
"1784","MG Burmester (ZIM)",54,6,1,7,24,6,30,0.444444444444444,0.111111111111111,0.555555555555556
"1785","MG Grell (WI)",34,0,0,0,0,0,0,0,0,0
"1786","MG Hughes (AUS)",1032,96,17,113,384,102,486,0.372093023255814,0.0988372093023256,0.47093023255814
"1787","MG Johnson (AUS)",2065,247,31,278,988,186,1174,0.478450363196126,0.0900726392251816,0.568523002421307
"1788","MG Melle (SA)",68,2,0,2,8,0,8,0.117647058823529,0,0.117647058823529
"1789","MG Vandort (SL)",1144,132,6,138,528,36,564,0.461538461538462,0.0314685314685315,0.493006993006993
"1790","MG Waite (AUS)",11,2,0,2,8,0,8,0.727272727272727,0,0.727272727272727
"1791","MG Webb (NZ)",12,0,0,0,0,0,0,0,0,0
"1792","MH Dekker (ZIM)",333,35,0,35,140,0,140,0.42042042042042,0,0.42042042042042
"1793","MH Denness (ENG)",1667,192,2,194,768,12,780,0.460707858428314,0.00719856028794241,0.467906418716257
"1794","MH Mankad (INDIA)",2109,108,7,115,432,42,474,0.204836415362731,0.0199146514935989,0.22475106685633
"1795","MH Richardson (NZ)",2684,332,4,336,1328,24,1352,0.49478390461997,0.00894187779433681,0.503725782414307
"1796","MHN Walker (AUS)",586,54,1,55,216,6,222,0.368600682593857,0.0102389078498294,0.378839590443686
"1797","MHW Papps (NZ)",246,37,0,37,148,0,148,0.601626016260163,0,0.601626016260163
"1798","MI Black (WI)",21,1,0,1,4,0,4,0.19047619047619,0,0.19047619047619
"1799","Miran Bakhsh (PAK)",1,0,0,0,0,0,0,0,0,0
"1800","Misbah-ul-Haq (PAK)",5222,511,81,592,2044,486,2530,0.39142091152815,0.0930677901187285,0.484488701646879
"1801","MJ Bennett (AUS)",71,5,0,5,20,0,20,0.28169014084507,0,0.28169014084507
"1802","MJ Clarke (AUS)",8643,978,39,1017,3912,234,4146,0.452620617841027,0.02707393266227,0.479694550503297
"1803","MJ Gopalan (INDIA)",18,0,0,0,0,0,0,0,0,0
"1804","MJ Greatbatch (NZ)",2067,229,9,238,916,54,970,0.443154329946783,0.0261248185776488,0.469279148524432
"1805","MJ Guptill (NZ)",2586,326,23,349,1304,138,1442,0.504253673627224,0.0533642691415313,0.557617942768755
"1806","MJ Hartigan (AUS)",170,18,0,18,72,0,72,0.423529411764706,0,0.423529411764706
"1807","MJ Haslam (NZ)",4,0,0,0,0,0,0,0,0,0
"1808","MJ Henry (NZ)",216,31,5,36,124,30,154,0.574074074074074,0.138888888888889,0.712962962962963
"1809","MJ Hilton (ENG)",37,0,1,1,0,6,6,0,0.162162162162162,0.162162162162162
"1810","MJ Hoggard (ENG)",473,42,0,42,168,0,168,0.355179704016913,0,0.355179704016913
"1811","MJ Horne (NZ)",1788,210,11,221,840,66,906,0.469798657718121,0.0369127516778524,0.506711409395973
"1812","MJ Horton (ENG)",60,6,0,6,24,0,24,0.4,0,0.4
"1813","MJ Leach (ENG)",30,3,0,3,12,0,12,0.4,0,0.4
"1814","MJ Macaulay (SA)",33,1,0,1,4,0,4,0.121212121212121,0,0.121212121212121
"1815","MJ Mason (NZ)",3,0,0,0,0,0,0,0,0,0
"1816","MJ McCague (ENG)",21,3,0,3,12,0,12,0.571428571428571,0,0.571428571428571
"1817","MJ Nicholson (AUS)",14,0,0,0,0,0,0,0,0,0
"1818","MJ North (AUS)",1171,143,5,148,572,30,602,0.488471391972673,0.0256191289496157,0.514090520922289
"1819","MJ Prior (ENG)",4099,492,16,508,1968,96,2064,0.48011710173213,0.0234203464259576,0.503537448158087
"1820","MJ Procter (SA)",226,21,3,24,84,18,102,0.371681415929204,0.079646017699115,0.451327433628319
"1821","MJ Saggers (ENG)",1,0,0,0,0,0,0,0,0,0
"1822","MJ Santner (NZ)",535,69,10,79,276,60,336,0.51588785046729,0.11214953271028,0.62803738317757
"1823","MJ Slater (AUS)",5312,598,30,628,2392,180,2572,0.450301204819277,0.0338855421686747,0.484186746987952
"1824","MJ Stewart (ENG)",385,27,2,29,108,12,120,0.280519480519481,0.0311688311688312,0.311688311688312
"1825","MJ Susskind (SA)",264,0,0,0,0,0,0,0,0,0
"1826","MJC Allom (ENG)",14,0,0,0,0,0,0,0,0,0
"1827","MJF Shrimpton (NZ)",265,22,1,23,88,6,94,0.332075471698113,0.0226415094339623,0.354716981132075
"1828","MJK Smith (ENG)",2278,182,10,192,728,60,788,0.319578577699737,0.0263388937664618,0.345917471466198
"1829","MJL Turnbull (ENG)",224,9,2,11,36,12,48,0.160714285714286,0.0535714285714286,0.214285714285714
"1830","MK Elgie (SA)",75,8,0,8,32,0,32,0.426666666666667,0,0.426666666666667
"1831","MK Mantri (INDIA)",67,0,0,0,0,0,0,0,0,0
"1832","MKDI Amerasinghe (SL)",0,0,0,0,0,0,0,NA,NA,NA
"1833","MKGCP Lakshitha (SL)",42,8,0,8,32,0,32,0.761904761904762,0,0.761904761904762
"1834","ML Apte (INDIA)",542,0,0,0,0,0,0,0,0,0
"1835","ML Cummins (WI)",95,10,3,13,40,18,58,0.421052631578947,0.189473684210526,0.610526315789474
"1836","ML Hayden (AUS)",8625,1049,82,1131,4196,492,4688,0.486492753623188,0.0570434782608696,0.543536231884058
"1837","ML Jaisimha (INDIA)",2056,198,12,210,792,72,864,0.385214007782101,0.0350194552529183,0.420233463035019
"1838","ML Love (AUS)",233,17,0,17,68,0,68,0.291845493562232,0,0.291845493562232
"1839","ML Nkala (ZIM)",187,23,1,24,92,6,98,0.491978609625668,0.0320855614973262,0.524064171122995
"1840","ML Page (NZ)",492,15,0,15,60,0,60,0.121951219512195,0,0.121951219512195
"1841","ML Su'a (NZ)",165,21,1,22,84,6,90,0.509090909090909,0.0363636363636364,0.545454545454545
"1842","ML Udawatte (SL)",23,2,0,2,8,0,8,0.347826086956522,0,0.347826086956522
"1843","MLC Foster (WI)",580,41,0,41,164,0,164,0.282758620689655,0,0.282758620689655
"1844","MM Ali (ENG)",2594,319,23,342,1276,138,1414,0.491904394757132,0.0531996915959908,0.545104086353123
"1845","MM Patel (ENG)",45,4,0,4,16,0,16,0.355555555555556,0,0.355555555555556
"1846","MM Patel (INDIA)",60,8,1,9,32,6,38,0.533333333333333,0.1,0.633333333333333
"1847","MM Sood (INDIA)",3,0,0,0,0,0,0,0,0,0
"1848","MN Hart (NZ)",353,45,0,45,180,0,180,0.509915014164306,0,0.509915014164306
"1849","MN Lathwell (ENG)",78,8,0,8,32,0,32,0.41025641025641,0,0.41025641025641
"1850","MN Nawaz (SL)",99,11,0,11,44,0,44,0.444444444444444,0,0.444444444444444
"1851","MN Samuels (WI)",3871,531,32,563,2124,192,2316,0.548695427538104,0.0495995866701111,0.598295014208215
"1852","MN Waller (ZIM)",577,68,1,69,272,6,278,0.471403812824957,0.0103986135181976,0.481802426343154
"1853","Mohammad Abbas (PAK)",22,2,0,2,8,0,8,0.363636363636364,0,0.363636363636364
"1854","Mohammad Akram (PAK)",24,2,0,2,8,0,8,0.333333333333333,0,0.333333333333333
"1855","Mohammad Amir (PAK)",702,85,3,88,340,18,358,0.484330484330484,0.0256410256410256,0.50997150997151
"1856","Mohammad Ashraful (BDESH)",2737,335,22,357,1340,132,1472,0.489587139203507,0.0482279868469127,0.53781512605042
"1857","Mohammad Asif (PAK)",141,19,0,19,76,0,76,0.539007092198582,0,0.539007092198582
"1858","Mohammad Aslam (PAK)",34,4,0,4,16,0,16,0.470588235294118,0,0.470588235294118
"1859","Mohammad Ayub (PAK)",47,4,0,4,16,0,16,0.340425531914894,0,0.340425531914894
"1860","Mohammad Farooq (PAK)",85,9,0,9,36,0,36,0.423529411764706,0,0.423529411764706
"1861","Mohammad Hafeez (PAK)",3452,429,28,457,1716,168,1884,0.497103128621089,0.048667439165701,0.54577056778679
"1862","Mohammad Hussain (PAK)",18,3,0,3,12,0,12,0.666666666666667,0,0.666666666666667
"1863","Mohammad Ilyas (PAK)",441,36,2,38,144,12,156,0.326530612244898,0.0272108843537415,0.353741496598639
"1864","Mohammad Irfan (PAK)",28,4,0,4,16,0,16,0.571428571428571,0,0.571428571428571
"1865","Mohammad Khalil (PAK)",9,2,0,2,8,0,8,0.888888888888889,0,0.888888888888889
"1866","Mohammad Munaf (PAK)",63,4,1,5,16,6,22,0.253968253968254,0.0952380952380952,0.349206349206349
"1867","Mohammad Nabi (AFG)",24,4,0,4,16,0,16,0.666666666666667,0,0.666666666666667
"1868","Mohammad Nawaz (3) (PAK)",50,4,0,4,16,0,16,0.32,0,0.32
"1869","Mohammad Nazir (PAK)",144,13,0,13,52,0,52,0.361111111111111,0,0.361111111111111
"1870","Mohammad Rafique (BDESH)",1059,110,34,144,440,204,644,0.415486307837583,0.192634560906516,0.608120868744098
"1871","Mohammad Ramzan (PAK)",36,4,0,4,16,0,16,0.444444444444444,0,0.444444444444444
"1872","Mohammad Rizwan (PAK)",13,2,0,2,8,0,8,0.615384615384615,0,0.615384615384615
"1873","Mohammad Salim (BDESH)",49,6,0,6,24,0,24,0.489795918367347,0,0.489795918367347
"1874","Mohammad Salman (PAK)",25,1,1,2,4,6,10,0.16,0.24,0.4
"1875","Mohammad Sami (PAK)",487,53,4,57,212,24,236,0.435318275154004,0.0492813141683778,0.484599589322382
"1876","Mohammad Shahid (BDESH)",57,10,1,11,40,6,46,0.701754385964912,0.105263157894737,0.807017543859649
"1877","Mohammad Shahzad (AFG)",27,6,0,6,24,0,24,0.888888888888889,0,0.888888888888889
"1878","Mohammad Sharif (BDESH)",122,10,4,14,40,24,64,0.327868852459016,0.19672131147541,0.524590163934426
"1879","Mohammad Talha (PAK)",34,4,2,6,16,12,28,0.470588235294118,0.352941176470588,0.823529411764706
"1880","Mohammad Wasim (PAK)",783,89,0,89,356,0,356,0.454661558109834,0,0.454661558109834
"1881","Mohammad Yousuf (PAK)",7530,957,51,1008,3828,306,4134,0.508366533864542,0.0406374501992032,0.549003984063745
"1882","Mohammad Zahid (PAK)",7,1,0,1,4,0,4,0.571428571428571,0,0.571428571428571
"1883","Mohammed Shami (INDIA)",424,44,16,60,176,96,272,0.415094339622642,0.226415094339623,0.641509433962264
"1884","Mohsin Kamal (PAK)",37,2,0,2,8,0,8,0.216216216216216,0,0.216216216216216
"1885","Mohsin Khan (PAK)",2709,258,6,264,1032,36,1068,0.380952380952381,0.0132890365448505,0.394241417497231
"1886","Moin Khan (PAK)",2695,325,27,352,1300,162,1462,0.482374768089054,0.0601113172541744,0.542486085343228
"1887","Mominul Haque (BDESH)",2170,250,5,255,1000,30,1030,0.460829493087558,0.0138248847926267,0.474654377880184
"1888","Mosaddek Hossain (BDESH)",104,11,2,13,44,12,56,0.423076923076923,0.115384615384615,0.538461538461538
"1889","MP Bicknell (ENG)",45,6,0,6,24,0,24,0.533333333333333,0,0.533333333333333
"1890","MP Bowden (ENG)",25,5,0,5,20,0,20,0.8,0,0.8
"1891","MP Donnelly (NZ)",582,50,1,51,200,6,206,0.343642611683849,0.0103092783505155,0.353951890034364
"1892","MP Fernandes (WI)",49,0,0,0,0,0,0,0,0,0
"1893","MP Jarvis (ZIM)",4,0,0,0,0,0,0,0,0,0
"1894","MP Maynard (ENG)",87,11,0,11,44,0,44,0.505747126436782,0,0.505747126436782
"1895","MP Vaughan (ENG)",5673,735,22,757,2940,132,3072,0.518244315177155,0.0232681121099947,0.54151242728715
"1896","MR Benson (ENG)",51,4,0,4,16,0,16,0.313725490196078,0,0.313725490196078
"1897","MR Bynoe (WI)",111,18,0,18,72,0,72,0.648648648648649,0,0.648648648648649
"1898","MR Gillespie (NZ)",76,10,3,13,40,18,58,0.526315789473684,0.236842105263158,0.763157894736842
"1899","MR Harvey (AUS)",43,5,0,5,20,0,20,0.465116279069767,0,0.465116279069767
"1900","MR Marsh (AUS)",1170,149,16,165,596,96,692,0.509401709401709,0.0820512820512821,0.591452991452991
"1901","MR Ramprakash (ENG)",2350,251,7,258,1004,42,1046,0.427234042553191,0.0178723404255319,0.445106382978723
"1902","MR Rege (INDIA)",15,0,0,0,0,0,0,0,0,0
"1903","MR Whitney (AUS)",68,4,0,4,16,0,16,0.235294117647059,0,0.235294117647059
"1904","MRCN Bandaratilleke (SL)",93,8,0,8,32,0,32,0.344086021505376,0,0.344086021505376
"1905","MRJ Veletta (AUS)",207,15,0,15,60,0,60,0.289855072463768,0,0.289855072463768
"1906","MS Atapattu (SL)",5502,685,4,689,2740,24,2764,0.498000727008361,0.00436205016357688,0.502362777171937
"1907","MS Crane (ENG)",6,0,0,0,0,0,0,0,0,0
"1908","MS Dhoni (INDIA)",4876,544,78,622,2176,468,2644,0.446267432321575,0.095980311730927,0.542247744052502
"1909","MS Hardikar (INDIA)",56,0,0,0,0,0,0,0,0,0
"1910","MS Kasprowicz (AUS)",445,46,3,49,184,18,202,0.413483146067416,0.0404494382022472,0.453932584269663
"1911","MS Nichols (ENG)",355,0,1,1,0,6,6,0,0.0169014084507042,0.0169014084507042
"1912","MS Panesar (ENG)",220,23,1,24,92,6,98,0.418181818181818,0.0272727272727273,0.445454545454545
"1913","MS Sinclair (NZ)",1635,197,7,204,788,42,830,0.481957186544342,0.0256880733944954,0.507645259938838
"1914","MS Wade (AUS)",886,86,8,94,344,48,392,0.388261851015801,0.054176072234763,0.442437923250564
"1915","MSK Prasad (INDIA)",106,6,0,6,24,0,24,0.226415094339623,0,0.226415094339623
"1916","MT Chinouya (ZIM)",1,0,0,0,0,0,0,0,0,0
"1917","MT Renshaw (AUS)",636,77,3,80,308,18,326,0.484276729559748,0.0283018867924528,0.512578616352201
"1918","MTG Elliott (AUS)",1172,155,4,159,620,24,644,0.52901023890785,0.0204778156996587,0.549488054607508
"1919","Mudassar Nazar (PAK)",4114,358,1,359,1432,6,1438,0.348079727758872,0.00145843461351483,0.349538162372387
"1920","Mufasir-ul-Haq (PAK)",8,0,0,0,0,0,0,0,0,0
"1921","Mujeeb Ur Rahman (AFG)",18,2,1,3,8,6,14,0.444444444444444,0.333333333333333,0.777777777777778
"1922","Munir Malik (PAK)",7,0,0,0,0,0,0,0,0,0
"1923","Mushfiqur Rahim (BDESH)",3699,452,29,481,1808,174,1982,0.488780751554474,0.0470397404703974,0.535820492024872
"1924","Mushfiqur Rahman (BDESH)",232,23,0,23,92,0,92,0.396551724137931,0,0.396551724137931
"1925","Mushtaq Ahmed (PAK)",656,70,8,78,280,48,328,0.426829268292683,0.0731707317073171,0.5
"1926","Mushtaq Mohammad (PAK)",3643,316,4,320,1264,24,1288,0.34696678561625,0.0065879769420807,0.353554762558331
"1927","Mustafizur Rahman (BDESH)",38,3,2,5,12,12,24,0.315789473684211,0.315789473684211,0.631578947368421
"1928","MV Boucher (ICC)",17,1,0,1,4,0,4,0.235294117647059,0,0.235294117647059
"1929","MV Boucher (SA)",5498,655,20,675,2620,120,2740,0.476536922517279,0.0218261185885777,0.498363041105857
"1930","MV Nagamootoo (WI)",185,22,3,25,88,18,106,0.475675675675676,0.0972972972972973,0.572972972972973
"1931","MV Narasimha Rao (INDIA)",46,5,0,5,20,0,20,0.434782608695652,0,0.434782608695652
"1932","MVT Fernando (SL)",4,0,0,0,0,0,0,0,0,0
"1933","MW Booth (ENG)",46,0,0,0,0,0,0,0,0,0
"1934","MW Gatting (ENG)",4409,552,11,563,2208,66,2274,0.500793830800635,0.0149693808119755,0.515763211612611
"1935","MW Goodwin (ZIM)",1414,165,5,170,660,30,690,0.466760961810467,0.0212164073550212,0.487977369165488
"1936","MW Priest (NZ)",56,6,0,6,24,0,24,0.428571428571429,0,0.428571428571429
"1937","MW Pringle (SA)",67,5,2,7,20,12,32,0.298507462686567,0.17910447761194,0.477611940298507
"1938","MW Rushmere (SA)",6,0,0,0,0,0,0,0,0,0
"1939","MW Sievers (AUS)",67,3,0,3,12,0,12,0.17910447761194,0,0.17910447761194
"1940","MW Tate (ENG)",1198,84,14,98,336,84,420,0.280467445742905,0.0701168614357262,0.350584307178631
"1941","MWW Selvey (ENG)",15,1,0,1,4,0,4,0.266666666666667,0,0.266666666666667
"1942","N Betancourt (WI)",52,0,0,0,0,0,0,0,0,0
"1943","N Boje (SA)",1312,184,6,190,736,36,772,0.560975609756098,0.0274390243902439,0.588414634146341
"1944","N Chopra (INDIA)",7,0,0,0,0,0,0,0,0,0
"1945","N Deonarine (WI)",725,78,7,85,312,42,354,0.430344827586207,0.0579310344827586,0.488275862068966
"1946","N Dickwella (SL)",1205,136,7,143,544,42,586,0.451452282157676,0.0348547717842324,0.486307053941909
"1947","N Gallichan (NZ)",32,0,0,0,0,0,0,0,0,0
"1948","N Gifford (ENG)",179,16,0,16,64,0,64,0.357541899441341,0,0.357541899441341
"1949","N Gordon (SA)",8,0,0,0,0,0,0,0,0,0
"1950","N Hussain (ENG)",5718,727,24,751,2908,144,3052,0.508569429870584,0.0251836306400839,0.533753060510668
"1951","N Kapil Dev (INDIA)",5294,592,61,653,2368,366,2734,0.447298828862864,0.0691348696637703,0.516433698526634
"1952","N M'shangwe (ZIM)",8,2,0,2,8,0,8,1,0,1
"1953","N Ncube (ZIM)",17,0,1,1,0,6,6,0,0.352941176470588,0.352941176470588
"1954","N Oldfield (ENG)",99,0,0,0,0,0,0,0,0,0
"1955","N Phillip (WI)",297,21,2,23,84,12,96,0.282828282828283,0.0404040404040404,0.323232323232323
"1956","N Pradeep (SL)",132,19,0,19,76,0,76,0.575757575757576,0,0.575757575757576
"1957","N Puna (NZ)",31,2,0,2,8,0,8,0.258064516129032,0,0.258064516129032
"1958","N Reid (SA)",17,2,0,2,8,0,8,0.470588235294118,0,0.470588235294118
"1959","N Wagner (NZ)",442,50,15,65,200,90,290,0.452488687782805,0.203619909502262,0.656108597285068
"1960","NA Foster (ENG)",446,54,4,58,216,24,240,0.484304932735426,0.0538116591928251,0.538116591928251
"1961","NA Knox (ENG)",24,0,0,0,0,0,0,0,0,0
"1962","NA Mallender (ENG)",8,0,0,0,0,0,0,0,0,0
"1963","NA Quinn (SA)",90,0,1,1,0,6,6,0,0.0666666666666667,0.0666666666666667
"1964","Nadeem Abbasi (PAK)",46,6,0,6,24,0,24,0.521739130434783,0,0.521739130434783
"1965","Nadeem Ghauri (PAK)",0,0,0,0,0,0,0,NA,NA,NA
"1966","Nadeem Khan (PAK)",34,1,0,1,4,0,4,0.117647058823529,0,0.117647058823529
"1967","Naeem Islam (BDESH)",416,52,4,56,208,24,232,0.5,0.0576923076923077,0.557692307692308
"1968","Nafees Iqbal (BDESH)",518,72,1,73,288,6,294,0.555984555984556,0.0115830115830116,0.567567567567568
"1969","Naimur Rahman (BDESH)",210,31,0,31,124,0,124,0.59047619047619,0,0.59047619047619
"1970","NAM McLean (WI)",322,31,11,42,124,66,190,0.385093167701863,0.204968944099379,0.590062111801242
"1971","Naoomal Jaoomal (INDIA)",108,0,0,0,0,0,0,0,0,0
"1972","Nasim-ul-Ghani (PAK)",747,51,2,53,204,12,216,0.273092369477912,0.0160642570281124,0.289156626506024
"1973","Nasir Hossain (BDESH)",1044,119,10,129,476,60,536,0.455938697318008,0.0574712643678161,0.513409961685824
"1974","Nasir Jamshed (PAK)",51,8,0,8,32,0,32,0.627450980392157,0,0.627450980392157
"1975","NAT Adcock (SA)",146,7,1,8,28,6,34,0.191780821917808,0.0410958904109589,0.232876712328767
"1976","Naushad Ali (PAK)",156,0,0,0,0,0,0,0,0,0
"1977","Naved-ul-Hasan (PAK)",239,32,5,37,128,30,158,0.535564853556485,0.125523012552301,0.661087866108787
"1978","Naved Anjum (PAK)",44,5,0,5,20,0,20,0.454545454545455,0,0.454545454545455
"1979","Naved Ashraf (PAK)",64,8,0,8,32,0,32,0.5,0,0.5
"1980","Naved Latif (PAK)",20,3,0,3,12,0,12,0.6,0,0.6
"1981","Nawab of Pataudi snr (ENG)",144,6,0,6,24,0,24,0.166666666666667,0,0.166666666666667
"1982","Nawab of Pataudi snr (INDIA)",55,0,0,0,0,0,0,0,0,0
"1983","Nazar Mohammad (PAK)",277,0,0,0,0,0,0,0,0,0
"1984","Nazimuddin (BDESH)",125,17,2,19,68,12,80,0.544,0.096,0.64
"1985","Nazmul Hossain (BDESH)",16,2,1,3,8,6,14,0.5,0.375,0.875
"1986","Nazmul Hossain Shanto (BDESH)",30,4,0,4,16,0,16,0.533333333333333,0,0.533333333333333
"1987","NB Mahwire (ZIM)",147,21,2,23,84,12,96,0.571428571428571,0.0816326530612245,0.653061224489796
"1988","NBF Mann (SA)",400,1,3,4,4,18,22,0.01,0.045,0.055
"1989","NC Johnson (ZIM)",532,60,4,64,240,24,264,0.451127819548872,0.0451127819548872,0.496240601503759
"1990","NC McGarrell (WI)",61,10,0,10,40,0,40,0.655737704918033,0,0.655737704918033
"1991","NC Tufnell (ENG)",14,0,0,0,0,0,0,0,0,0
"1992","NCL O'Neill (AUS)",2779,241,4,245,964,24,988,0.346887369557395,0.00863620007196833,0.355523569629363
"1993","ND Hirwani (INDIA)",54,6,0,6,24,0,24,0.444444444444444,0,0.444444444444444
"1994","ND Howard (ENG)",86,0,0,0,0,0,0,0,0,0
"1995","ND McKenzie (SA)",3253,409,22,431,1636,132,1768,0.502920381186597,0.0405779280664002,0.543498309252997
"1996","NE Haig (ENG)",126,6,0,6,24,0,24,0.19047619047619,0,0.19047619047619
"1997","NE Marshall (WI)",8,0,0,0,0,0,0,0,0,0
"1998","NF Druce (ENG)",252,21,0,21,84,0,84,0.333333333333333,0,0.333333333333333
"1999","NF Williams (ENG)",38,6,0,6,24,0,24,0.631578947368421,0,0.631578947368421
"2000","NFD Thomson (AUS)",67,0,0,0,0,0,0,0,0,0
"2001","NG Cowans (ENG)",175,25,3,28,100,18,118,0.571428571428571,0.102857142857143,0.674285714285714
"2002","NGB Cook (ENG)",179,16,0,16,64,0,64,0.357541899441341,0,0.357541899441341
"2003","NH Fairbrother (ENG)",219,22,2,24,88,12,100,0.401826484018265,0.0547945205479452,0.45662100456621
"2004","NHCD Theunissen (SA)",2,0,0,0,0,0,0,0,0,0
"2005","NI Thomson (ENG)",69,9,0,9,36,0,36,0.521739130434783,0,0.521739130434783
"2006","Niaz Ahmed (PAK)",17,0,0,0,0,0,0,0,0,0
"2007","NJ Astle (NZ)",4702,612,39,651,2448,234,2682,0.520629519353467,0.0497660569970225,0.570395576350489
"2008","NJ Contractor (INDIA)",1611,57,2,59,228,12,240,0.141527001862197,0.0074487895716946,0.148975791433892
"2009","NJ Maddinson (AUS)",27,3,0,3,12,0,12,0.444444444444444,0,0.444444444444444
"2010","NJ O'Brien (IRE)",18,2,0,2,8,0,8,0.444444444444444,0,0.444444444444444
"2011","NJN Hawke (AUS)",365,17,0,17,68,0,68,0.186301369863014,0,0.186301369863014
"2012","NLTC Perera (SL)",203,21,4,25,84,24,108,0.413793103448276,0.118226600985222,0.532019704433498
"2013","NM Hauritz (AUS)",426,50,3,53,200,18,218,0.469483568075117,0.0422535211267606,0.511737089201878
"2014","NM Kulkarni (INDIA)",5,0,0,0,0,0,0,0,0,0
"2015","NM Lyon (AUS)",820,109,4,113,436,24,460,0.531707317073171,0.0292682926829268,0.560975609756098
"2016","NM Parker (NZ)",89,7,1,8,28,6,34,0.314606741573034,0.0674157303370786,0.382022471910112
"2017","NO Miller (WI)",5,0,0,0,0,0,0,0,0,0
"2018","NO Norton (SA)",9,0,0,0,0,0,0,0,0,0
"2019","NO Perry (WI)",74,8,0,8,32,0,32,0.432432432432432,0,0.432432432432432
"2020","NR Chowdhury (INDIA)",3,0,0,0,0,0,0,0,0,0
"2021","NR Ferreira (ZIM)",21,2,0,2,8,0,8,0.380952380952381,0,0.380952380952381
"2022","NR Mongia (INDIA)",1442,159,5,164,636,30,666,0.441054091539528,0.0208044382801664,0.461858529819695
"2023","NRD Compton (ENG)",775,84,3,87,336,18,354,0.433548387096774,0.0232258064516129,0.456774193548387
"2024","NS Asgarali (WI)",62,6,0,6,24,0,24,0.387096774193548,0,0.387096774193548
"2025","NS Harford (NZ)",229,11,0,11,44,0,44,0.192139737991266,0,0.192139737991266
"2026","NS Mitchell-Innes (ENG)",5,0,0,0,0,0,0,0,0,0
"2027","NS Sidhu (INDIA)",3202,358,38,396,1432,228,1660,0.447220487195503,0.0712054965646471,0.51842598376015
"2028","NS Tamhane (INDIA)",225,4,0,4,16,0,16,0.0711111111111111,0,0.0711111111111111
"2029","NS Yadav (INDIA)",403,30,1,31,120,6,126,0.297766749379653,0.0148883374689826,0.312655086848635
"2030","NT Broom (NZ)",32,5,0,5,20,0,20,0.625,0,0.625
"2031","NT Paranavitana (SL)",1792,206,5,211,824,30,854,0.459821428571429,0.0167410714285714,0.4765625
"2032","NT Pascal (WI)",12,2,0,2,8,0,8,0.666666666666667,0,0.666666666666667
"2033","Nurul Hasan (BDESH)",115,11,2,13,44,12,56,0.382608695652174,0.104347826086957,0.48695652173913
"2034","NV Knight (ENG)",719,74,2,76,296,12,308,0.411682892906815,0.0166898470097357,0.428372739916551
"2035","NV Lindsay (SA)",35,4,0,4,16,0,16,0.457142857142857,0,0.457142857142857
"2036","NV Ojha (INDIA)",56,7,0,7,28,0,28,0.5,0,0.5
"2037","NV Radford (ENG)",21,1,0,1,4,0,4,0.19047619047619,0,0.19047619047619
"2038","NW Bracken (AUS)",70,7,0,7,28,0,28,0.4,0,0.4
"2039","NWD Yardley (ENG)",812,43,0,43,172,0,172,0.211822660098522,0,0.211822660098522
"2040","O Henry (SA)",53,5,1,6,20,6,26,0.377358490566038,0.113207547169811,0.490566037735849
"2041","OA Shah (ENG)",269,35,3,38,140,18,158,0.520446096654275,0.0669144981412639,0.587360594795539
"2042","OAC Banks (WI)",318,42,2,44,168,12,180,0.528301886792453,0.0377358490566038,0.566037735849057
"2043","OC da Costa (WI)",153,3,0,3,12,0,12,0.0784313725490196,0,0.0784313725490196
"2044","OC Dawson (SA)",293,2,0,2,8,0,8,0.0273037542662116,0,0.0273037542662116
"2045","OC Scott (WI)",171,7,1,8,28,6,34,0.16374269005848,0.0350877192982456,0.198830409356725
"2046","OD Gibson (WI)",93,14,0,14,56,0,56,0.602150537634409,0,0.602150537634409
"2047","OE Nothling (AUS)",52,7,0,7,28,0,28,0.538461538461538,0,0.538461538461538
"2048","OE Wynne (SA)",219,0,0,0,0,0,0,0,0,0
"2049","OG Smith (WI)",1331,79,12,91,316,72,388,0.237415477084899,0.0540946656649136,0.291510142749812
"2050","OJ Phillips (WI)",160,16,0,16,64,0,64,0.4,0,0.4
"2051","OJ Pope (ENG)",54,7,0,7,28,0,28,0.518518518518518,0,0.518518518518518
"2052","OR Dunell (SA)",42,4,0,4,16,0,16,0.380952380952381,0,0.380952380952381
"2053","P Bhandari (INDIA)",77,0,0,0,0,0,0,0,0,0
"2054","P Holmes (ENG)",357,4,0,4,16,0,16,0.0448179271708683,0,0.0448179271708683
"2055","P Hutchinson (SA)",14,1,0,1,4,0,4,0.285714285714286,0,0.285714285714286
"2056","P Krishnamurthy (INDIA)",33,1,0,1,4,0,4,0.121212121212121,0,0.121212121212121
"2057","P Kumar (INDIA)",149,21,5,26,84,30,114,0.563758389261745,0.201342281879195,0.76510067114094
"2058","P Lever (ENG)",350,32,1,33,128,6,134,0.365714285714286,0.0171428571428571,0.382857142857143
"2059","P Roy (INDIA)",2513,70,1,71,280,6,286,0.11142061281337,0.00238758456028651,0.113808197373657
"2060","P Utseya (ZIM)",107,12,1,13,48,6,54,0.448598130841121,0.0560747663551402,0.504672897196262
"2061","P Willey (ENG)",1184,160,4,164,640,24,664,0.540540540540541,0.0202702702702703,0.560810810810811
"2062","P Wilson (AUS)",0,0,0,0,0,0,0,NA,NA,NA
"2063","PA de Silva (SL)",6361,756,48,804,3024,288,3312,0.475396950165068,0.0452759000157208,0.520672850180789
"2064","PA Emery (AUS)",8,1,0,1,4,0,4,0.5,0,0.5
"2065","PA Gibb (ENG)",581,15,0,15,60,0,60,0.103270223752151,0,0.103270223752151
"2066","PA Hibbert (AUS)",15,1,0,1,4,0,4,0.266666666666667,0,0.266666666666667
"2067","PA Horne (NZ)",71,7,0,7,28,0,28,0.394366197183099,0,0.394366197183099
"2068","PA Jaques (AUS)",902,99,3,102,396,18,414,0.439024390243902,0.0199556541019956,0.458980044345898
"2069","PA McAlister (AUS)",256,16,0,16,64,0,64,0.25,0,0.25
"2070","PA Patel (INDIA)",934,126,1,127,504,6,510,0.539614561027837,0.00642398286937901,0.546038543897216
"2071","PA Strang (ZIM)",839,92,3,95,368,18,386,0.438617401668653,0.0214541120381406,0.460071513706794
"2072","PA Wallace (WI)",279,40,2,42,160,12,172,0.573476702508961,0.043010752688172,0.616487455197133
"2073","PADLR Sandakan (SL)",108,18,0,18,72,0,72,0.666666666666667,0,0.666666666666667
"2074","PAJ DeFreitas (ENG)",934,103,8,111,412,48,460,0.441113490364026,0.0513918629550321,0.492505353319058
"2075","PAM Hands (SA)",300,2,4,6,8,24,32,0.0266666666666667,0.08,0.106666666666667
"2076","Pankaj Singh (INDIA)",10,2,0,2,8,0,8,0.8,0,0.8
"2077","PB Dassanayake (SL)",196,21,0,21,84,0,84,0.428571428571429,0,0.428571428571429
"2078","PB Truscott (NZ)",29,0,0,0,0,0,0,0,0,0
"2079","PBH May (ENG)",4537,406,12,418,1624,72,1696,0.357945779149218,0.0158695173021821,0.3738152964514
"2080","PC Charlton (AUS)",29,0,0,0,0,0,0,0,0,0
"2081","PC Strydom (SA)",35,5,0,5,20,0,20,0.571428571428571,0,0.571428571428571
"2082","PCR Tufnell (ENG)",153,13,0,13,52,0,52,0.339869281045752,0,0.339869281045752
"2083","PD Collingwood (ENG)",4259,470,24,494,1880,144,2024,0.441418173280113,0.0338107536980512,0.475228926978164
"2084","PD Lashley (WI)",159,12,1,13,48,6,54,0.30188679245283,0.0377358490566038,0.339622641509434
"2085","PDRL Perera (SL)",33,4,0,4,16,0,16,0.484848484848485,0,0.484848484848485
"2086","PE McEwan (NZ)",96,6,0,6,24,0,24,0.25,0,0.25
"2087","PE McIntyre (AUS)",22,3,0,3,12,0,12,0.545454545454545,0,0.545454545454545
"2088","PE Palia (INDIA)",29,0,0,0,0,0,0,0,0,0
"2089","PE Richardson (ENG)",2061,178,0,178,712,0,712,0.345463367297428,0,0.345463367297428
"2090","PE Whitelaw (NZ)",64,0,0,0,0,0,0,0,0,0
"2091","Pervez Sajjad (PAK)",123,6,1,7,24,6,30,0.195121951219512,0.0487804878048781,0.24390243902439
"2092","PEW Jones (WI)",47,0,0,0,0,0,0,0,0,0
"2093","PF Warner (ENG)",626,36,0,36,144,0,144,0.230031948881789,0,0.230031948881789
"2094","PG Fulton (NZ)",967,117,18,135,468,108,576,0.483971044467425,0.111685625646329,0.595656670113754
"2095","PG Joshi (INDIA)",207,7,0,7,28,0,28,0.135265700483092,0,0.135265700483092
"2096","PG McShane (AUS)",26,2,0,2,8,0,8,0.307692307692308,0,0.307692307692308
"2097","PGH Fender (ENG)",380,16,1,17,64,6,70,0.168421052631579,0.0157894736842105,0.184210526315789
"2098","PGV van der Bijl (SA)",460,33,3,36,132,18,150,0.28695652173913,0.0391304347826087,0.326086956521739
"2099","PGZ Harris (NZ)",378,17,2,19,68,12,80,0.17989417989418,0.0317460317460317,0.211640211640212
"2100","PH Carlson (AUS)",23,2,0,2,8,0,8,0.347826086956522,0,0.347826086956522
"2101","PH Edmonds (ENG)",875,84,9,93,336,54,390,0.384,0.0617142857142857,0.445714285714286
"2102","PH Parfitt (ENG)",1882,208,2,210,832,12,844,0.442082890541977,0.00637619553666312,0.44845908607864
"2103","PH Punjabi (INDIA)",164,0,0,0,0,0,0,0,0,0
"2104","PH Sharma (INDIA)",187,21,2,23,84,12,96,0.449197860962567,0.0641711229946524,0.513368983957219
"2105","PHJ Trimborn (SA)",13,0,0,0,0,0,0,0,0,0
"2106","PHT Kaushal (SL)",106,16,0,16,64,0,64,0.60377358490566,0,0.60377358490566
"2107","PI Philpott (AUS)",93,1,0,1,4,0,4,0.043010752688172,0,0.043010752688172
"2108","PI Pocock (ENG)",206,18,1,19,72,6,78,0.349514563106796,0.029126213592233,0.378640776699029
"2109","PIC Thompson (WI)",17,2,1,3,8,6,14,0.470588235294118,0.352941176470588,0.823529411764706
"2110","PJ Cummins (AUS)",365,39,9,48,156,54,210,0.427397260273973,0.147945205479452,0.575342465753425
"2111","PJ Hughes (AUS)",1535,199,11,210,796,66,862,0.5185667752443,0.0429967426710098,0.561563517915309
"2112","PJ Ingram (NZ)",61,5,1,6,20,6,26,0.327868852459016,0.0983606557377049,0.426229508196721
"2113","PJ Loader (ENG)",76,6,0,6,24,0,24,0.315789473684211,0,0.315789473684211
"2114","PJ Martin (ENG)",115,10,2,12,40,12,52,0.347826086956522,0.104347826086957,0.452173913043478
"2115","PJ Moor (ZIM)",374,35,4,39,140,24,164,0.374331550802139,0.0641711229946524,0.438502673796791
"2116","PJ Newport (ENG)",110,13,0,13,52,0,52,0.472727272727273,0,0.472727272727273
"2117","PJ Petherick (NZ)",34,2,0,2,8,0,8,0.235294117647059,0,0.235294117647059
"2118","PJ Sharpe (ENG)",786,95,0,95,380,0,380,0.483460559796438,0,0.483460559796438
"2119","PJ Wiseman (NZ)",366,42,4,46,168,24,192,0.459016393442623,0.0655737704918033,0.524590163934426
"2120","PJL Dujon (WI)",3368,361,11,372,1444,66,1510,0.42874109263658,0.0195961995249406,0.44833729216152
"2121","PJP Burge (AUS)",2290,192,6,198,768,36,804,0.335371179039301,0.0157205240174672,0.351091703056769
"2122","PJR Steyn (SA)",81,11,0,11,44,0,44,0.54320987654321,0,0.54320987654321
"2123","PJW Allott (ENG)",213,20,1,21,80,6,86,0.375586854460094,0.028169014084507,0.403755868544601
"2124","PK Amre (INDIA)",425,44,3,47,176,18,194,0.414117647058824,0.0423529411764706,0.456470588235294
"2125","PK Lee (AUS)",57,9,0,9,36,0,36,0.631578947368421,0,0.631578947368421
"2126","PK Sen (INDIA)",165,9,1,10,36,6,42,0.218181818181818,0.0363636363636364,0.254545454545455
"2127","PK Wijetunge (SL)",10,2,0,2,8,0,8,0.8,0,0.8
"2128","PL Harris (SA)",460,47,3,50,188,18,206,0.408695652173913,0.0391304347826087,0.447826086956522
"2129","PL Mhambrey (INDIA)",58,8,0,8,32,0,32,0.551724137931034,0,0.551724137931034
"2130","PL Symcox (SA)",741,80,12,92,320,72,392,0.431848852901485,0.097165991902834,0.529014844804318
"2131","PL Taylor (AUS)",431,37,0,37,148,0,148,0.34338747099768,0,0.34338747099768
"2132","PL van der Merwe (SA)",533,20,1,21,80,6,86,0.150093808630394,0.0112570356472795,0.161350844277674
"2133","PL Winslow (SA)",186,15,5,20,60,30,90,0.32258064516129,0.161290322580645,0.483870967741935
"2134","PLS Gamage (SL)",6,0,0,0,0,0,0,0,0,0
"2135","PM Hornibrook (AUS)",60,3,0,3,12,0,12,0.2,0,0.2
"2136","PM Nevill (AUS)",468,52,1,53,208,6,214,0.444444444444444,0.0128205128205128,0.457264957264957
"2137","PM Pollock (SA)",607,27,1,28,108,6,114,0.177924217462932,0.00988467874794069,0.187808896210873
"2138","PM Pushpakumara (SL)",42,6,1,7,24,6,30,0.571428571428571,0.142857142857143,0.714285714285714
"2139","PM Siddle (AUS)",1063,116,4,120,464,24,488,0.436500470366886,0.0225776105362183,0.459078080903104
"2140","PM Such (ENG)",67,7,0,7,28,0,28,0.417910447761194,0,0.417910447761194
"2141","PM Toohey (AUS)",893,81,4,85,324,24,348,0.362821948488242,0.0268756998880179,0.38969764837626
"2142","PM Walker (ENG)",128,14,2,16,56,12,68,0.4375,0.09375,0.53125
"2143","PN Kirsten (SA)",626,67,0,67,268,0,268,0.428115015974441,0,0.428115015974441
"2144","PN Webb (NZ)",11,0,0,0,0,0,0,0,0,0
"2145","PNF Mansell (SA)",355,44,0,44,176,0,176,0.495774647887324,0,0.495774647887324
"2146","PP Chawla (INDIA)",6,1,0,1,4,0,4,0.666666666666667,0,0.666666666666667
"2147","PP Ojha (INDIA)",89,6,0,6,24,0,24,0.269662921348315,0,0.269662921348315
"2148","PR Adams (SA)",360,32,4,36,128,24,152,0.355555555555556,0.0666666666666667,0.422222222222222
"2149","PR Carlstein (SA)",190,14,0,14,56,0,56,0.294736842105263,0,0.294736842105263
"2150","PR Downton (ENG)",785,67,0,67,268,0,268,0.34140127388535,0,0.34140127388535
"2151","PR George (AUS)",2,0,0,0,0,0,0,0,0,0
"2152","PR Reiffel (AUS)",955,103,0,103,412,0,412,0.431413612565445,0,0.431413612565445
"2153","PR Sleep (AUS)",483,35,0,35,140,0,140,0.289855072463768,0,0.289855072463768
"2154","PR Stirling (IRE)",28,4,0,4,16,0,16,0.571428571428571,0,0.571428571428571
"2155","PR Umrigar (INDIA)",3631,151,4,155,604,24,628,0.166345359405123,0.006609749380336,0.172955108785459
"2156","PS de Villiers (SA)",359,36,5,41,144,30,174,0.401114206128134,0.0835654596100279,0.484679665738162
"2157","PS Heine (SA)",209,12,4,16,48,24,72,0.229665071770335,0.114832535885167,0.344497607655502
"2158","PS Masvaure (ZIM)",55,8,0,8,32,0,32,0.581818181818182,0,0.581818181818182
"2159","PS McDonnell (AUS)",955,79,4,83,316,24,340,0.330890052356021,0.025130890052356,0.356020942408377
"2160","PS Twentyman-Jones (SA)",0,0,0,0,0,0,0,NA,NA,NA
"2161","PSP Handscomb (AUS)",829,91,1,92,364,6,370,0.439083232810615,0.00723763570566948,0.446320868516285
"2162","PT Barton (NZ)",285,22,0,22,88,0,88,0.308771929824561,0,0.308771929824561
"2163","PT Collins (WI)",235,30,0,30,120,0,120,0.51063829787234,0,0.51063829787234
"2164","PT Lewis (SA)",0,0,0,0,0,0,0,NA,NA,NA
"2165","PV Simmons (WI)",956,122,4,126,488,24,512,0.510460251046025,0.0251046025104603,0.535564853556485
"2166","PVD Chameera (SL)",61,9,0,9,36,0,36,0.590163934426229,0,0.590163934426229
"2167","PW Jarvis (ENG)",132,11,0,11,44,0,44,0.333333333333333,0,0.333333333333333
"2168","PW Sherwell (SA)",427,57,1,58,228,6,234,0.533957845433255,0.0140515222482436,0.548009367681499
"2169","PWG Parker (ENG)",13,2,0,2,8,0,8,0.615384615384615,0,0.615384615384615
"2170","Q de Kock (SA)",1925,240,17,257,960,102,1062,0.498701298701299,0.052987012987013,0.551688311688312
"2171","Q McMillan (SA)",306,15,3,18,60,18,78,0.196078431372549,0.0588235294117647,0.254901960784314
"2172","Qaiser Abbas (PAK)",2,0,0,0,0,0,0,0,0,0
"2173","Qasim Umar (PAK)",1548,131,0,131,524,0,524,0.338501291989664,0,0.338501291989664
"2174","R Abel (ENG)",744,56,0,56,224,0,224,0.301075268817204,0,0.301075268817204
"2175","R Appleyard (ENG)",51,4,0,4,16,0,16,0.313725490196078,0,0.313725490196078
"2176","R Ashwin (INDIA)",2289,260,14,274,1040,84,1124,0.454346876365225,0.036697247706422,0.491044124071647
"2177","R Beaumont (SA)",70,0,0,0,0,0,0,0,0,0
"2178","R Benaud (AUS)",2201,182,8,190,728,48,776,0.330758746024534,0.0218082689686506,0.352567014993185
"2179","R Berry (ENG)",6,1,0,1,4,0,4,0.666666666666667,0,0.666666666666667
"2180","R Chandrika (WI)",140,11,0,11,44,0,44,0.314285714285714,0,0.314285714285714
"2181","R Clarke (ENG)",96,8,1,9,32,6,38,0.333333333333333,0.0625,0.395833333333333
"2182","R Dhanraj (WI)",17,1,0,1,4,0,4,0.235294117647059,0,0.235294117647059
"2183","R Dravid (ICC)",23,3,0,3,12,0,12,0.521739130434783,0,0.521739130434783
"2184","R Dravid (INDIA)",13265,1651,21,1672,6604,126,6730,0.497851488880513,0.00949868073878628,0.507350169619299
"2185","R Dumbrill (SA)",153,9,0,9,36,0,36,0.235294117647059,0,0.235294117647059
"2186","R Edwards (AUS)",1171,104,1,105,416,6,422,0.355251921434671,0.00512382578992314,0.360375747224594
"2187","R Gilchrist (WI)",60,4,0,4,16,0,16,0.266666666666667,0,0.266666666666667
"2188","R Graham (SA)",6,0,0,0,0,0,0,0,0,0
"2189","R Howorth (ENG)",145,0,0,0,0,0,0,0,0,0
"2190","R Illingworth (ENG)",1836,172,3,175,688,18,706,0.374727668845316,0.00980392156862745,0.384531590413943
"2191","R Kilner (ENG)",233,19,0,19,76,0,76,0.32618025751073,0,0.32618025751073
"2192","R Lamba (INDIA)",102,5,0,5,20,0,20,0.196078431372549,0,0.196078431372549
"2193","R McLaren (SA)",47,6,0,6,24,0,24,0.51063829787234,0,0.51063829787234
"2194","R Mutumbami (ZIM)",217,29,1,30,116,6,122,0.534562211981567,0.0276497695852535,0.56221198156682
"2195","R Nanan (WI)",16,0,0,0,0,0,0,0,0,0
"2196","R Peel (ENG)",427,25,0,25,100,0,100,0.234192037470726,0,0.234192037470726
"2197","R Pilling (ENG)",91,5,0,5,20,0,20,0.21978021978022,0,0.21978021978022
"2198","R Pollard (ENG)",13,0,0,0,0,0,0,0,0,0
"2199","R Rampaul (WI)",335,40,10,50,160,60,220,0.477611940298507,0.17910447761194,0.656716417910448
"2200","R Singh (INDIA)",0,0,0,0,0,0,0,NA,NA,NA
"2201","R Subba Row (ENG)",984,58,1,59,232,6,238,0.235772357723577,0.00609756097560976,0.241869918699187
"2202","R Swetman (ENG)",254,12,0,12,48,0,48,0.188976377952756,0,0.188976377952756
"2203","R Tattersall (ENG)",50,2,0,2,8,0,8,0.16,0,0.16
"2204","R Vijay Bharadwaj (INDIA)",28,2,0,2,8,0,8,0.285714285714286,0,0.285714285714286
"2205","R Vinay Kumar (INDIA)",11,2,0,2,8,0,8,0.727272727272727,0,0.727272727272727
"2206","R Wood (ENG)",6,0,0,0,0,0,0,0,0,0
"2207","RA Austin (WI)",61,7,0,7,28,0,28,0.459016393442623,0,0.459016393442623
"2208","RA Duff (AUS)",1317,95,0,95,380,0,380,0.288534548215642,0,0.288534548215642
"2209","RA Gaunt (AUS)",6,0,0,0,0,0,0,0,0,0
"2210","RA Gleeson (SA)",4,0,0,0,0,0,0,0,0,0
"2211","RA Hamence (AUS)",81,4,0,4,16,0,16,0.197530864197531,0,0.197530864197531
"2212","RA Harper (WI)",535,52,9,61,208,54,262,0.388785046728972,0.100934579439252,0.489719626168224
"2213","RA Hutton (ENG)",219,29,1,30,116,6,122,0.529680365296804,0.0273972602739726,0.557077625570776
"2214","RA Jadeja (INDIA)",1196,122,33,155,488,198,686,0.408026755852843,0.165551839464883,0.573578595317726
"2215","RA Jones (NZ)",23,1,0,1,4,0,4,0.173913043478261,0,0.173913043478261
"2216","RA Legall (WI)",50,0,0,0,0,0,0,0,0,0
"2217","RA McLean (SA)",2120,225,12,237,900,72,972,0.424528301886792,0.0339622641509434,0.458490566037736
"2218","RA Reifer (WI)",52,6,1,7,24,6,30,0.461538461538462,0.115384615384615,0.576923076923077
"2219","RA Saggers (AUS)",30,0,0,0,0,0,0,0,0,0
"2220","RA Sinfield (ENG)",6,0,0,0,0,0,0,0,0,0
"2221","RA Smith (ENG)",4190,550,11,561,2200,66,2266,0.525059665871122,0.0157517899761337,0.540811455847255
"2222","RA Woolmer (ENG)",1105,135,2,137,540,12,552,0.48868778280543,0.0108597285067873,0.499547511312217
"2223","RA Young (ENG)",27,4,0,4,16,0,16,0.592592592592593,0,0.592592592592593
"2224","RA Young (NZ)",169,19,1,20,76,6,82,0.449704142011834,0.0355029585798817,0.485207100591716
"2225","Rafiqul Islam (BDESH)",7,1,0,1,4,0,4,0.571428571428571,0,0.571428571428571
"2226","Rahat Ali (PAK)",136,19,3,22,76,18,94,0.558823529411765,0.132352941176471,0.691176470588235
"2227","Rahmat Shah (AFG)",18,2,0,2,8,0,8,0.444444444444444,0,0.444444444444444
"2228","Rajin Saleh (BDESH)",1141,138,5,143,552,30,582,0.483786152497809,0.0262927256792287,0.510078878177038
"2229","Rajinder Pal (INDIA)",6,0,0,0,0,0,0,0,0,0
"2230","RAL Massie (AUS)",78,3,2,5,12,12,24,0.153846153846154,0.153846153846154,0.307692307692308
"2231","Rameez Raja (PAK)",2833,307,3,310,1228,18,1246,0.433462760324744,0.00635368866925521,0.439816448993999
"2232","Ranjan Das (BDESH)",2,0,0,0,0,0,0,0,0,0
"2233","RAP Nissanka (SL)",18,2,0,2,8,0,8,0.444444444444444,0,0.444444444444444
"2234","Raqibul Hasan (BDESH)",336,37,1,38,148,6,154,0.44047619047619,0.0178571428571429,0.458333333333333
"2235","RAS Lakmal (SL)",619,86,3,89,344,18,362,0.555735056542811,0.0290791599353796,0.584814216478191
"2236","Rashid Khan (AFG)",19,2,0,2,8,0,8,0.421052631578947,0,0.421052631578947
"2237","Rashid Khan (PAK)",155,21,0,21,84,0,84,0.541935483870968,0,0.541935483870968
"2238","Rashid Latif (PAK)",1381,156,5,161,624,30,654,0.451846488052136,0.0217233888486604,0.473569876900797
"2239","RB Desai (INDIA)",418,27,1,28,108,6,114,0.258373205741627,0.0143540669856459,0.272727272727273
"2240","RB Kanhai (WI)",6227,566,23,589,2264,138,2402,0.363577966918259,0.0221615545206359,0.385739521438895
"2241","RB Kenny (INDIA)",245,0,0,0,0,0,0,0,0,0
"2242","RB Kerr (AUS)",31,0,0,0,0,0,0,0,0,0
"2243","RB McCosker (AUS)",1622,143,3,146,572,18,590,0.352651048088779,0.0110974106041924,0.363748458692972
"2244","RB Minnett (AUS)",395,39,0,39,156,0,156,0.394936708860759,0,0.394936708860759
"2245","RB Richardson (WI)",5949,761,23,784,3044,138,3182,0.511682635737099,0.0231971759959657,0.534879811733064
"2246","RB Simpson (AUS)",4869,349,2,351,1396,12,1408,0.286711850482645,0.00246457178065311,0.289176422263298
"2247","RB Stewart (SA)",13,0,0,0,0,0,0,0,0,0
"2248","RC Allen (AUS)",44,3,0,3,12,0,12,0.272727272727273,0,0.272727272727273
"2249","RC Blunt (NZ)",330,8,0,8,32,0,32,0.096969696969697,0,0.096969696969697
"2250","RC Fredericks (WI)",4334,425,8,433,1700,48,1748,0.392247346562067,0.0110752191970466,0.403322565759114
"2251","RC Irani (ENG)",86,11,0,11,44,0,44,0.511627906976744,0,0.511627906976744
"2252","RC Miller (WI)",23,0,0,0,0,0,0,0,0,0
"2253","RC Motz (NZ)",612,53,14,67,212,84,296,0.34640522875817,0.137254901960784,0.483660130718954
"2254","RC Russell (ENG)",1851,201,0,201,804,0,804,0.434359805510535,0,0.434359805510535
"2255","RC Saxena (INDIA)",25,3,0,3,12,0,12,0.48,0,0.48
"2256","RD Jackman (ENG)",42,2,0,2,8,0,8,0.19047619047619,0,0.19047619047619
"2257","RD Jacobs (WI)",2577,300,23,323,1200,138,1338,0.465657741559953,0.0535506402793946,0.519208381839348
"2258","RD King (WI)",66,7,0,7,28,0,28,0.424242424242424,0,0.424242424242424
"2259","RD Parkar (INDIA)",80,10,0,10,40,0,40,0.5,0,0.5
"2260","RD Robinson (AUS)",100,14,0,14,56,0,56,0.56,0,0.56
"2261","RD Woolley (AUS)",21,3,0,3,12,0,12,0.571428571428571,0,0.571428571428571
"2262","RDB Croft (ENG)",421,50,2,52,200,12,212,0.475059382422803,0.0285035629453682,0.503562945368171
"2263","RE Foster (ENG)",602,61,1,62,244,6,250,0.40531561461794,0.00996677740863787,0.415282392026578
"2264","RE Grieveson (SA)",114,3,0,3,12,0,12,0.105263157894737,0,0.105263157894737
"2265","RE Marshall (WI)",143,11,0,11,44,0,44,0.307692307692308,0,0.307692307692308
"2266","RE Redmond (NZ)",163,29,0,29,116,0,116,0.711656441717791,0,0.711656441717791
"2267","RES Wyatt (ENG)",1839,57,6,63,228,36,264,0.123980424143556,0.0195758564437194,0.143556280587276
"2268","Rev.DS Sheppard (ENG)",1172,104,1,105,416,6,422,0.354948805460751,0.00511945392491468,0.360068259385666
"2269","RF Surti (INDIA)",1263,84,2,86,336,12,348,0.26603325415677,0.00950118764845606,0.275534441805226
"2270","RG Archer (AUS)",713,67,9,76,268,54,322,0.375876577840112,0.0757363253856942,0.451612903225806
"2271","RG Barlow (ENG)",591,31,0,31,124,0,124,0.209813874788494,0,0.209813874788494
"2272","RG de Alwis (SL)",152,12,2,14,48,12,60,0.315789473684211,0.0789473684210526,0.394736842105263
"2273","RG Draper (SA)",25,0,0,0,0,0,0,0,0,0
"2274","RG Gregory (AUS)",153,7,0,7,28,0,28,0.183006535947712,0,0.183006535947712
"2275","RG Hart (NZ)",260,18,0,18,72,0,72,0.276923076923077,0,0.276923076923077
"2276","RG Holland (AUS)",35,3,0,3,12,0,12,0.342857142857143,0,0.342857142857143
"2277","RG Nadkarni (INDIA)",1414,80,2,82,320,12,332,0.226308345120226,0.00848656294200849,0.234794908062235
"2278","RG Pollock (SA)",2256,289,11,300,1156,66,1222,0.512411347517731,0.0292553191489362,0.541666666666667
"2279","RG Samuels (WI)",372,52,4,56,208,24,232,0.559139784946237,0.0645161290322581,0.623655913978495
"2280","RG Sharma (INDIA)",1479,144,29,173,576,174,750,0.389452332657201,0.117647058823529,0.50709939148073
"2281","RG Twose (NZ)",628,63,7,70,252,42,294,0.401273885350318,0.0668789808917197,0.468152866242038
"2282","RGA Headley (WI)",62,7,0,7,28,0,28,0.451612903225806,0,0.451612903225806
"2283","RGCE Wijesuriya (SL)",22,0,0,0,0,0,0,0,0,0
"2284","RGD Willis (ENG)",840,79,1,80,316,6,322,0.376190476190476,0.00714285714285714,0.383333333333333
"2285","RGM Patel (INDIA)",0,0,0,0,0,0,0,NA,NA,NA
"2286","RH Catterall (SA)",1555,36,8,44,144,48,192,0.092604501607717,0.0308681672025723,0.123472668810289
"2287","RH Robinson (AUS)",5,0,0,0,0,0,0,0,0,0
"2288","RH Scott (NZ)",18,3,0,3,12,0,12,0.666666666666667,0,0.666666666666667
"2289","RH Shodhan (INDIA)",181,15,0,15,60,0,60,0.331491712707182,0,0.331491712707182
"2290","RH Spooner (ENG)",481,25,1,26,100,6,106,0.207900207900208,0.0124740124740125,0.22037422037422
"2291","RH Vance (NZ)",207,22,0,22,88,0,88,0.42512077294686,0,0.42512077294686
"2292","RHD Sellers (AUS)",0,0,0,0,0,0,0,NA,NA,NA
"2293","RHM Hands (SA)",7,0,0,0,0,0,0,0,0,0
"2294","RI Harford (NZ)",7,0,0,0,0,0,0,0,0,0
"2295","Riaz Afridi (PAK)",9,2,0,2,8,0,8,0.888888888888889,0,0.888888888888889
"2296","RIC Holder (WI)",380,41,1,42,164,6,170,0.431578947368421,0.0157894736842105,0.447368421052632
"2297","Rizwan-uz-Zaman (PAK)",345,17,0,17,68,0,68,0.197101449275362,0,0.197101449275362
"2298","RJ Bailey (ENG)",119,8,0,8,32,0,32,0.26890756302521,0,0.26890756302521
"2299","RJ Blakey (ENG)",7,1,0,1,4,0,4,0.571428571428571,0,0.571428571428571
"2300","RJ Bright (AUS)",445,44,2,46,176,12,188,0.395505617977528,0.0269662921348315,0.42247191011236
"2301","RJ Christiani (WI)",896,26,2,28,104,12,116,0.116071428571429,0.0133928571428571,0.129464285714286
"2302","RJ Crisp (SA)",123,8,1,9,32,6,38,0.260162601626016,0.0487804878048781,0.308943089430894
"2303","RJ Harris (AUS)",603,63,9,72,252,54,306,0.417910447761194,0.0895522388059701,0.507462686567164
"2304","RJ Inverarity (AUS)",174,20,0,20,80,0,80,0.459770114942529,0,0.459770114942529
"2305","RJ Kennedy (NZ)",28,4,0,4,16,0,16,0.571428571428571,0,0.571428571428571
"2306","RJ Kirtley (ENG)",32,1,1,2,4,6,10,0.125,0.1875,0.3125
"2307","RJ Nicol (NZ)",28,2,0,2,8,0,8,0.285714285714286,0,0.285714285714286
"2308","RJ Peterson (SA)",464,61,2,63,244,12,256,0.525862068965517,0.0258620689655172,0.551724137931034
"2309","RJ Pope (AUS)",3,0,0,0,0,0,0,0,0,0
"2310","RJ Quiney (AUS)",9,1,0,1,4,0,4,0.444444444444444,0,0.444444444444444
"2311","RJ Ratnayake (SL)",433,35,10,45,140,60,200,0.323325635103926,0.138568129330254,0.46189376443418
"2312","RJ Shastri (INDIA)",3830,317,22,339,1268,132,1400,0.331070496083551,0.0344647519582245,0.365535248041775
"2313","RJ Sidebottom (ENG)",313,37,0,37,148,0,148,0.472843450479233,0,0.472843450479233
"2314","RJ Westcott (SA)",166,10,0,10,40,0,40,0.240963855421687,0,0.240963855421687
"2315","RJD Jamshedji (INDIA)",5,0,0,0,0,0,0,0,0,0
"2316","RK Chauhan (INDIA)",98,10,3,13,40,18,58,0.408163265306122,0.183673469387755,0.591836734693878
"2317","RK Illingworth (ENG)",128,15,0,15,60,0,60,0.46875,0,0.46875
"2318","RK Kleinveldt (SA)",27,1,2,3,4,12,16,0.148148148148148,0.444444444444444,0.592592592592593
"2319","RK Nunes (WI)",245,19,0,19,76,0,76,0.310204081632653,0,0.310204081632653
"2320","RK Oxenham (AUS)",151,9,0,9,36,0,36,0.23841059602649,0,0.23841059602649
"2321","RK Tyldesley (ENG)",47,1,1,2,4,6,10,0.0851063829787234,0.127659574468085,0.212765957446809
"2322","RKJ Dawson (ENG)",114,14,0,14,56,0,56,0.491228070175439,0,0.491228070175439
"2323","RL Chase (WI)",1242,137,7,144,548,42,590,0.44122383252818,0.0338164251207729,0.475040257648953
"2324","RL Dias (SL)",1285,141,1,142,564,6,570,0.438910505836576,0.0046692607003891,0.443579766536965
"2325","RL Fuller (WI)",1,0,0,0,0,0,0,0,0,0
"2326","RL Harvey (SA)",51,0,1,1,0,6,6,0,0.117647058823529,0.117647058823529
"2327","RL Johnson (ENG)",59,6,3,9,24,18,42,0.406779661016949,0.305084745762712,0.711864406779661
"2328","RL Park (AUS)",0,0,0,0,0,0,0,NA,NA,NA
"2329","RL Powell (WI)",53,10,0,10,40,0,40,0.754716981132076,0,0.754716981132076
"2330","RL Sanghvi (INDIA)",2,0,0,0,0,0,0,0,0,0
"2331","RM Cowper (AUS)",2061,156,0,156,624,0,624,0.302765647743814,0,0.302765647743814
"2332","RM Edwards (WI)",65,5,0,5,20,0,20,0.307692307692308,0,0.307692307692308
"2333","RM Ellison (ENG)",202,23,0,23,92,0,92,0.455445544554455,0,0.455445544554455
"2334","RM Harris (NZ)",31,4,0,4,16,0,16,0.516129032258065,0,0.516129032258065
"2335","RM Hogg (AUS)",439,45,1,46,180,6,186,0.41002277904328,0.0136674259681093,0.42369020501139
"2336","RM Poore (SA)",76,0,0,0,0,0,0,0,0,0
"2337","RM Prideaux (ENG)",102,8,0,8,32,0,32,0.313725490196078,0,0.313725490196078
"2338","RMH Binny (INDIA)",876,69,5,74,276,30,306,0.315068493150685,0.0342465753424658,0.349315068493151
"2339","RMH Cottam (ENG)",27,1,0,1,4,0,4,0.148148148148148,0,0.148148148148148
"2340","RMS Eranga (SL)",193,26,0,26,104,0,104,0.538860103626943,0,0.538860103626943
"2341","RN Harvey (AUS)",6149,452,1,453,1808,6,1814,0.294031549845503,0.000975768417628883,0.295007318263132
"2342","RN Lewis (WI)",89,15,0,15,60,0,60,0.674157303370786,0,0.674157303370786
"2343","RNS Hobbs (ENG)",34,2,1,3,8,6,14,0.235294117647059,0.176470588235294,0.411764705882353
"2344","RO Butcher (ENG)",71,9,0,9,36,0,36,0.507042253521127,0,0.507042253521127
"2345","RO Collinge (NZ)",533,43,7,50,172,42,214,0.322701688555347,0.0787992495309568,0.401500938086304
"2346","RO Hinds (WI)",459,54,2,56,216,12,228,0.470588235294118,0.0261437908496732,0.496732026143791
"2347","RO Jenkins (ENG)",198,0,0,0,0,0,0,0,0,0
"2348","RO Scarlett (WI)",54,0,0,0,0,0,0,0,0,0
"2349","RO Schwarz (SA)",378,21,1,22,84,6,90,0.222222222222222,0.0158730158730159,0.238095238095238
"2350","Robiul Islam (BDESH)",99,13,3,16,52,18,70,0.525252525252525,0.181818181818182,0.707070707070707
"2351","RP Arnold (SL)",1821,222,3,225,888,18,906,0.487644151565074,0.00988467874794069,0.497528830313015
"2352","RP Burl (ZIM)",16,3,0,3,12,0,12,0.75,0,0.75
"2353","RP de Groen (NZ)",45,6,0,6,24,0,24,0.533333333333333,0,0.533333333333333
"2354","RP Singh (INDIA)",116,16,1,17,64,6,70,0.551724137931034,0.0517241379310345,0.603448275862069
"2355","RP Snell (SA)",95,14,0,14,56,0,56,0.589473684210526,0,0.589473684210526
"2356","RPW Guneratne (SL)",0,0,0,0,0,0,0,NA,NA,NA
"2357","RR Dower (SA)",9,0,0,0,0,0,0,0,0,0
"2358","RR Jumadeen (WI)",84,2,0,2,8,0,8,0.0952380952380952,0,0.0952380952380952
"2359","RR Kulkarni (INDIA)",2,0,0,0,0,0,0,0,0,0
"2360","RR Lindwall (AUS)",1502,137,13,150,548,78,626,0.364846870838882,0.051930758988016,0.416777629826897
"2361","RR Pant (INDIA)",43,4,2,6,16,12,28,0.372093023255814,0.27906976744186,0.651162790697674
"2362","RR Powar (INDIA)",13,2,0,2,8,0,8,0.615384615384615,0,0.615384615384615
"2363","RR Ramdass (WI)",26,3,0,3,12,0,12,0.461538461538462,0,0.461538461538462
"2364","RR Sarwan (WI)",5842,747,14,761,2988,84,3072,0.511468675111263,0.0143786374529271,0.52584731256419
"2365","RR Singh (INDIA)",27,4,0,4,16,0,16,0.592592592592593,0,0.592592592592593
"2366","RS Bopara (ENG)",575,71,2,73,284,12,296,0.493913043478261,0.0208695652173913,0.514782608695652
"2367","RS Cunis (NZ)",295,23,0,23,92,0,92,0.311864406779661,0,0.311864406779661
"2368","RS Grant (WI)",220,4,3,7,16,18,34,0.0727272727272727,0.0818181818181818,0.154545454545455
"2369","RS Kalpage (SL)",294,35,4,39,140,24,164,0.476190476190476,0.0816326530612245,0.557823129251701
"2370","RS Kaluwitharana (SL)",1933,284,6,290,1136,36,1172,0.587687532333161,0.0186239006725297,0.606311433005691
"2371","RS Madugalle (SL)",1075,103,2,105,412,12,424,0.383255813953488,0.0111627906976744,0.394418604651163
"2372","RS Mahanama (SL)",2576,293,2,295,1172,12,1184,0.454968944099379,0.0046583850931677,0.459627329192547
"2373","RS Modi (INDIA)",736,16,0,16,64,0,64,0.0869565217391304,0,0.0869565217391304
"2374","RS Morton (WI)",573,79,7,86,316,42,358,0.551483420593368,0.0732984293193717,0.62478184991274
"2375","RSA Jayasekera (SL)",2,0,0,0,0,0,0,0,0,0
"2376","RT Barber (NZ)",17,0,0,0,0,0,0,0,0,0
"2377","RT Latham (NZ)",219,27,1,28,108,6,114,0.493150684931507,0.0273972602739726,0.520547945205479
"2378","RT Ponting (AUS)",13378,1509,73,1582,6036,438,6474,0.451188518463148,0.0327403199282404,0.483928838391389
"2379","RT Robinson (ENG)",1601,182,0,182,728,0,728,0.45471580262336,0,0.45471580262336
"2380","RT Simpson (ENG)",1401,96,5,101,384,30,414,0.274089935760171,0.0214132762312634,0.295503211991435
"2381","RT Spooner (ENG)",354,0,0,0,0,0,0,0,0,0
"2382","RT Stanyforth (ENG)",9,0,0,0,0,0,0,0,0,0
"2383","RTD Perks (ENG)",3,0,0,0,0,0,0,0,0,0
"2384","Rubel Hossain (BDESH)",259,33,4,37,132,24,156,0.50965250965251,0.0926640926640927,0.602316602316602
"2385","RV Divecha (INDIA)",60,1,0,1,4,0,4,0.0666666666666667,0,0.0666666666666667
"2386","RW Anderson (NZ)",423,43,1,44,172,6,178,0.40661938534279,0.0141843971631206,0.42080378250591
"2387","RW Barber (ENG)",1495,114,3,117,456,18,474,0.305016722408027,0.0120401337792642,0.317056856187291
"2388","RW Blair (NZ)",189,15,2,17,60,12,72,0.317460317460317,0.0634920634920635,0.380952380952381
"2389","RW Chakabva (ZIM)",618,51,4,55,204,24,228,0.330097087378641,0.0388349514563107,0.368932038834951
"2390","RW Marsh (AUS)",3633,381,24,405,1524,144,1668,0.419488026424443,0.0396366639141206,0.459124690338563
"2391","RW McLeod (AUS)",146,5,0,5,20,0,20,0.136986301369863,0,0.136986301369863
"2392","RW Morgan (NZ)",734,68,0,68,272,0,272,0.370572207084469,0,0.370572207084469
"2393","RW Price (ZIM)",261,41,1,42,164,6,170,0.628352490421456,0.0229885057471264,0.651340996168582
"2394","RW Taylor (ENG)",1156,100,1,101,400,6,406,0.346020761245675,0.00519031141868512,0.35121107266436
"2395","RW Tolchard (ENG)",129,10,0,10,40,0,40,0.310077519379845,0,0.310077519379845
"2396","RWG Emery (NZ)",46,0,0,0,0,0,0,0,0,0
"2397","RWT Key (ENG)",775,97,2,99,388,12,400,0.500645161290323,0.0154838709677419,0.516129032258065
"2398","RWV Robins (ENG)",612,49,0,49,196,0,196,0.320261437908497,0,0.320261437908497
"2399","S Abid Ali (INDIA)",1018,84,0,84,336,0,336,0.330058939096267,0,0.330058939096267
"2400","S Amarnath (INDIA)",550,42,1,43,168,6,174,0.305454545454545,0.0109090909090909,0.316363636363636
"2401","S Badrinath (INDIA)",63,8,0,8,32,0,32,0.507936507936508,0,0.507936507936508
"2402","S Chanderpaul (WI)",11867,1285,36,1321,5140,216,5356,0.433133900733125,0.0182017359062948,0.45133563663942
"2403","S Chattergoon (WI)",127,16,0,16,64,0,64,0.503937007874016,0,0.503937007874016
"2404","S Christopherson (ENG)",17,0,0,0,0,0,0,0,0,0
"2405","S Dhawan (INDIA)",2311,316,12,328,1264,72,1336,0.546949372565989,0.0311553440069234,0.578104716572912
"2406","S Elworthy (SA)",72,10,0,10,40,0,40,0.555555555555556,0,0.555555555555556
"2407","S Guha (INDIA)",17,1,0,1,4,0,4,0.235294117647059,0,0.235294117647059
"2408","S Haigh (ENG)",113,6,0,6,24,0,24,0.212389380530973,0,0.212389380530973
"2409","S Jeganathan (SL)",19,3,0,3,12,0,12,0.631578947368421,0,0.631578947368421
"2410","S Kalavitigoda (SL)",8,1,0,1,4,0,4,0.5,0,0.5
"2411","S Madan Lal (INDIA)",1042,87,1,88,348,6,354,0.333973128598848,0.00575815738963532,0.339731285988484
"2412","S Matsikenyeri (ZIM)",351,46,3,49,184,18,202,0.524216524216524,0.0512820512820513,0.575498575498576
"2413","S Morris (AUS)",14,1,0,1,4,0,4,0.285714285714286,0,0.285714285714286
"2414","S Mushtaq Ali (INDIA)",612,26,0,26,104,0,104,0.169934640522876,0,0.169934640522876
"2415","S Nazir Ali (INDIA)",30,0,0,0,0,0,0,0,0,0
"2416","S Nyalchand (INDIA)",7,0,0,0,0,0,0,0,0,0
"2417","S O'Linn (SA)",297,23,1,24,92,6,98,0.30976430976431,0.0202020202020202,0.32996632996633
"2418","S Prasanna (SL)",5,0,0,0,0,0,0,0,0,0
"2419","S Ragoonath (WI)",13,1,0,1,4,0,4,0.307692307692308,0,0.307692307692308
"2420","S Ramadhin (WI)",361,20,0,20,80,0,80,0.221606648199446,0,0.221606648199446
"2421","S Ramesh (INDIA)",1321,155,0,155,620,0,620,0.469341408024224,0,0.469341408024224
"2422","S Ranatunga (SL)",531,56,0,56,224,0,224,0.421845574387947,0,0.421845574387947
"2423","S Randiv (SL)",147,16,0,16,64,0,64,0.435374149659864,0,0.435374149659864
"2424","S Samarawickrama (SL)",125,17,1,18,68,6,74,0.544,0.048,0.592
"2425","S Shillingford (WI)",266,30,9,39,120,54,174,0.451127819548872,0.203007518796992,0.654135338345865
"2426","S Shivnarine (WI)",379,37,0,37,148,0,148,0.390501319261214,0,0.390501319261214
"2427","S Sreesanth (INDIA)",281,38,4,42,152,24,176,0.540925266903915,0.0854092526690391,0.626334519572954
"2428","S van Zyl (SA)",395,59,0,59,236,0,236,0.59746835443038,0,0.59746835443038
"2429","S Venkataraghavan (INDIA)",748,49,3,52,196,18,214,0.262032085561497,0.0240641711229947,0.286096256684492
"2430","S Viswanath (INDIA)",31,0,0,0,0,0,0,0,0,0
"2431","S Wazir Ali (INDIA)",237,0,0,0,0,0,0,0,0,0
"2432","S Wettimuny (SL)",1221,114,0,114,456,0,456,0.373464373464373,0,0.373464373464373
"2433","S Young (AUS)",4,1,0,1,4,0,4,1,0,1
"2434","SA Ankola (INDIA)",6,1,0,1,4,0,4,0.666666666666667,0,0.666666666666667
"2435","SA Banerjee (INDIA)",0,0,0,0,0,0,0,NA,NA,NA
"2436","SA Durani (INDIA)",1202,126,15,141,504,90,594,0.419301164725458,0.0748752079866889,0.494176372712146
"2437","SA Muller (AUS)",6,1,0,1,4,0,4,0.666666666666667,0,0.666666666666667
"2438","SA Thomson (NZ)",958,133,6,139,532,36,568,0.555323590814196,0.0375782881002088,0.592901878914405
"2439","Sabbir Rahman (BDESH)",481,57,6,63,228,36,264,0.474012474012474,0.0748440748440748,0.548856548856549
"2440","Sadiq Mohammad (PAK)",2625,247,0,247,988,0,988,0.376380952380952,0,0.376380952380952
"2441","Saeed Ahmed (PAK)",2991,197,4,201,788,24,812,0.263457037780007,0.00802407221664995,0.271481109996657
"2442","Saeed Ajmal (PAK)",451,44,4,48,176,24,200,0.390243902439024,0.0532150776053215,0.443458980044346
"2443","Saeed Anwar (PAK)",4052,535,14,549,2140,84,2224,0.528134254689042,0.0207305034550839,0.548864758144126
"2444","Sajedul Islam (BDESH)",18,2,0,2,8,0,8,0.444444444444444,0,0.444444444444444
"2445","Salahuddin (PAK)",117,0,0,0,0,0,0,0,0,0
"2446","Saleem Altaf (PAK)",276,16,1,17,64,6,70,0.231884057971014,0.0217391304347826,0.253623188405797
"2447","Saleem Elahi (PAK)",436,50,2,52,200,12,212,0.458715596330275,0.0275229357798165,0.486238532110092
"2448","Saleem Jaffar (PAK)",42,0,0,0,0,0,0,0,0,0
"2449","Saleem Malik (PAK)",5768,678,7,685,2712,42,2754,0.470180305131761,0.00728155339805825,0.47746185852982
"2450","Saleem Yousuf (PAK)",1055,100,4,104,400,24,424,0.37914691943128,0.0227488151658768,0.401895734597156
"2451","Salman Butt (PAK)",1889,276,1,277,1104,6,1110,0.584436209634727,0.00317628374801482,0.587612493382742
"2452","Sami Aslam (PAK)",758,77,4,81,308,24,332,0.406332453825858,0.0316622691292876,0.437994722955145
"2453","Sanwar Hossain (BDESH)",345,40,0,40,160,0,160,0.463768115942029,0,0.463768115942029
"2454","Saqlain Mushtaq (PAK)",927,82,7,89,328,42,370,0.353829557713053,0.0453074433656958,0.399137001078749
"2455","SAR Silva (SL)",353,17,0,17,68,0,68,0.192634560906516,0,0.192634560906516
"2456","Sarandeep Singh (INDIA)",43,1,0,1,4,0,4,0.0930232558139535,0,0.0930232558139535
"2457","Sarfraz Ahmed (PAK)",2267,229,7,236,916,42,958,0.404058226731363,0.0185266872518747,0.422584913983238
"2458","Sarfraz Nawaz (PAK)",1045,93,1,94,372,6,378,0.355980861244019,0.00574162679425837,0.361722488038278
"2459","SB Bangar (INDIA)",470,57,3,60,228,18,246,0.485106382978723,0.0382978723404255,0.523404255319149
"2460","SB Doull (NZ)",524,68,9,77,272,54,326,0.519083969465649,0.103053435114504,0.622137404580153
"2461","SB Joshi (INDIA)",352,36,4,40,144,24,168,0.409090909090909,0.0681818181818182,0.477272727272727
"2462","SB O'Connor (NZ)",103,7,0,7,28,0,28,0.271844660194175,0,0.271844660194175
"2463","SB Smith (AUS)",41,6,0,6,24,0,24,0.585365853658537,0,0.585365853658537
"2464","SB Styris (NZ)",1586,205,13,218,820,78,898,0.517023959646911,0.0491803278688525,0.566204287515763
"2465","SC Cook (SA)",632,66,0,66,264,0,264,0.417721518987342,0,0.417721518987342
"2466","SC Ganguly (INDIA)",7212,900,57,957,3600,342,3942,0.499168053244592,0.0474209650582363,0.546589018302829
"2467","SC Griffith (ENG)",157,15,0,15,60,0,60,0.382165605095541,0,0.382165605095541
"2468","SC Guillen (NZ)",98,3,2,5,12,12,24,0.122448979591837,0.122448979591837,0.244897959183673
"2469","SC Guillen (WI)",104,12,0,12,48,0,48,0.461538461538462,0,0.461538461538462
"2470","SC Joseph (WI)",147,20,1,21,80,6,86,0.54421768707483,0.0408163265306122,0.585034013605442
"2471","SC Kerrigan (ENG)",1,0,0,0,0,0,0,0,0,0
"2472","SC Stayers (WI)",58,0,0,0,0,0,0,0,0,0
"2473","SC Williams (WI)",1137,164,6,170,656,36,692,0.576956904133685,0.0316622691292876,0.608619173262973
"2474","SC Williams (ZIM)",421,58,1,59,232,6,238,0.551068883610451,0.0142517814726841,0.565320665083135
"2475","SCG MacGill (AUS)",349,38,2,40,152,12,164,0.435530085959885,0.0343839541547278,0.469914040114613
"2476","SCJ Broad (ENG)",3025,374,37,411,1496,222,1718,0.494545454545455,0.0733884297520661,0.567933884297521
"2477","SD Anurasiri (SL)",91,5,0,5,20,0,20,0.21978021978022,0,0.21978021978022
"2478","SD Hope (WI)",1210,145,5,150,580,30,610,0.479338842975207,0.0247933884297521,0.504132231404959
"2479","SD Jack (SA)",7,0,0,0,0,0,0,0,0,0
"2480","SD Robson (ENG)",336,42,1,43,168,6,174,0.5,0.0178571428571429,0.517857142857143
"2481","SD Snooke (SA)",0,0,0,0,0,0,0,NA,NA,NA
"2482","SD Udal (ENG)",109,14,1,15,56,6,62,0.513761467889908,0.055045871559633,0.568807339449541
"2483","SE Bond (NZ)",168,20,4,24,80,24,104,0.476190476190476,0.142857142857143,0.619047619047619
"2484","SE Gregory (AUS)",2282,157,0,157,628,0,628,0.275197195442594,0,0.275197195442594
"2485","SE Marsh (AUS)",2068,243,7,250,972,42,1014,0.470019342359768,0.0203094777562863,0.490328820116054
"2486","SF Barnes (ENG)",246,6,0,6,24,0,24,0.0975609756097561,0,0.0975609756097561
"2487","SF Burke (SA)",42,1,1,2,4,6,10,0.0952380952380952,0.142857142857143,0.238095238095238
"2488","SF Mire (ZIM)",78,12,1,13,48,6,54,0.615384615384615,0.0769230769230769,0.692307692307692
"2489","SF Rehman (PAK)",10,0,0,0,0,0,0,0,0,0
"2490","SFAF Bacchus (WI)",782,76,3,79,304,18,322,0.388746803069054,0.0230179028132992,0.411764705882353
"2491","SG Barnes (AUS)",1072,93,2,95,372,12,384,0.347014925373134,0.0111940298507463,0.358208955223881
"2492","SG Borthwick (ENG)",5,1,0,1,4,0,4,0.8,0,0.8
"2493","SG Gedye (NZ)",193,10,0,10,40,0,40,0.207253886010363,0,0.207253886010363
"2494","SG Law (AUS)",54,1,0,1,4,0,4,0.0740740740740741,0,0.0740740740740741
"2495","SG Peall (ZIM)",60,9,0,9,36,0,36,0.6,0,0.6
"2496","SG Shinde (INDIA)",85,0,0,0,0,0,0,0,0,0
"2497","SH Cook (AUS)",3,0,0,0,0,0,0,0,0,0
"2498","SH Curnow (SA)",168,12,0,12,48,0,48,0.285714285714286,0,0.285714285714286
"2499","SH Emery (AUS)",6,0,0,0,0,0,0,0,0,0
"2500","Shabbir Ahmed (PAK)",88,10,0,10,40,0,40,0.454545454545455,0,0.454545454545455
"2501","Shadab Kabir (PAK)",148,22,0,22,88,0,88,0.594594594594595,0,0.594594594594595
"2502","Shadab Khan (PAK)",188,25,0,25,100,0,100,0.531914893617021,0,0.531914893617021
"2503","Shafiq Ahmed (PAK)",99,10,0,10,40,0,40,0.404040404040404,0,0.404040404040404
"2504","Shafiul Islam (BDESH)",211,31,3,34,124,18,142,0.587677725118483,0.0853080568720379,0.672985781990521
"2505","Shafqat Rana (PAK)",221,13,1,14,52,6,58,0.235294117647059,0.0271493212669683,0.262443438914027
"2506","Shahadat Hossain (BDESH)",521,69,6,75,276,36,312,0.529750479846449,0.0690978886756238,0.598848368522073
"2507","Shahid Afridi (PAK)",1716,220,52,272,880,312,1192,0.512820512820513,0.181818181818182,0.694638694638695
"2508","Shahid Israr (PAK)",7,0,0,0,0,0,0,0,0,0
"2509","Shahid Mahmood (PAK)",25,3,0,3,12,0,12,0.48,0,0.48
"2510","Shahid Nazir (PAK)",194,22,2,24,88,12,100,0.45360824742268,0.0618556701030928,0.515463917525773
"2511","Shahid Saeed (PAK)",12,1,0,1,4,0,4,0.333333333333333,0,0.333333333333333
"2512","Shahriar Hossain (BDESH)",99,14,0,14,56,0,56,0.565656565656566,0,0.565656565656566
"2513","Shahriar Nafees (BDESH)",1267,189,1,190,756,6,762,0.596685082872928,0.00473559589581689,0.601420678768745
"2514","Shakeel Ahmed jnr (PAK)",74,8,0,8,32,0,32,0.432432432432432,0,0.432432432432432
"2515","Shakeel Ahmed snr (PAK)",1,0,0,0,0,0,0,0,0,0
"2516","Shakib Al Hasan (BDESH)",3692,462,19,481,1848,114,1962,0.500541711809317,0.0308775731310943,0.531419284940412
"2517","Shamsur Rahman (BDESH)",305,40,3,43,160,18,178,0.524590163934426,0.059016393442623,0.583606557377049
"2518","Shan Masood (PAK)",565,50,4,54,200,24,224,0.353982300884956,0.0424778761061947,0.39646017699115
"2519","Sharjeel Khan (PAK)",44,7,1,8,28,6,34,0.636363636363636,0.136363636363636,0.772727272727273
"2520","SHM Colah (INDIA)",69,0,0,0,0,0,0,0,0,0
"2521","Shoaib Akhtar (PAK)",544,53,22,75,212,132,344,0.389705882352941,0.242647058823529,0.632352941176471
"2522","Shoaib Malik (PAK)",1898,239,17,256,956,102,1058,0.503688092729189,0.053740779768177,0.557428872497366
"2523","Shoaib Mohammad (PAK)",2751,292,5,297,1168,30,1198,0.42457288258815,0.0109051254089422,0.435478007997092
"2524","Shujauddin (PAK)",395,7,0,7,28,0,28,0.0708860759493671,0,0.0708860759493671
"2525","Shuvagata Hom (BDESH)",244,29,0,29,116,0,116,0.475409836065574,0,0.475409836065574
"2526","SI de Saram (SL)",117,15,0,15,60,0,60,0.512820512820513,0,0.512820512820513
"2527","SI Mahmood (ENG)",81,10,0,10,40,0,40,0.493827160493827,0,0.493827160493827
"2528","Sikandar Raza (ZIM)",762,79,9,88,316,54,370,0.414698162729659,0.0708661417322835,0.485564304461942
"2529","Sikander Bakht (PAK)",146,5,0,5,20,0,20,0.136986301369863,0,0.136986301369863
"2530","Sir RJ Hadlee (NZ)",3124,343,33,376,1372,198,1570,0.439180537772087,0.0633802816901408,0.502560819462228
"2531","SJ Benn (WI)",486,58,13,71,232,78,310,0.477366255144033,0.160493827160494,0.637860082304527
"2532","SJ Cook (SA)",107,10,0,10,40,0,40,0.373831775700935,0,0.373831775700935
"2533","SJ Harmison (ENG)",742,97,10,107,388,60,448,0.522911051212938,0.0808625336927224,0.60377358490566
"2534","SJ Harmison (ICC)",1,0,0,0,0,0,0,0,0,0
"2535","SJ McCabe (AUS)",2748,269,5,274,1076,30,1106,0.39155749636099,0.0109170305676856,0.402474526928675
"2536","SJ Pegler (SA)",360,10,1,11,40,6,46,0.111111111111111,0.0166666666666667,0.127777777777778
"2537","SJ Rhodes (ENG)",294,28,2,30,112,12,124,0.380952380952381,0.0408163265306122,0.421768707482993
"2538","SJ Rixon (AUS)",394,33,0,33,132,0,132,0.33502538071066,0,0.33502538071066
"2539","SJ Snooke (SA)",1008,57,0,57,228,0,228,0.226190476190476,0,0.226190476190476
"2540","SJ Staples (ENG)",65,0,0,0,0,0,0,0,0,0
"2541","SJE Brown (ENG)",11,2,0,2,8,0,8,0.727272727272727,0,0.727272727272727
"2542","SJE Loxton (AUS)",554,38,5,43,152,30,182,0.274368231046931,0.0541516245487365,0.328519855595668
"2543","SK Coen (SA)",101,0,0,0,0,0,0,0,0,0
"2544","SK Raina (INDIA)",768,100,4,104,400,24,424,0.520833333333333,0.03125,0.552083333333333
"2545","SK Sharma (INDIA)",56,9,0,9,36,0,36,0.642857142857143,0,0.642857142857143
"2546","SK Warne (AUS)",3154,353,37,390,1412,222,1634,0.447685478757134,0.0703868103994927,0.518072289156627
"2547","SKL de Silva (SL)",36,3,0,3,12,0,12,0.333333333333333,0,0.333333333333333
"2548","SL Boock (NZ)",207,13,0,13,52,0,52,0.251207729468599,0,0.251207729468599
"2549","SL Campbell (WI)",2882,373,9,382,1492,54,1546,0.517696044413602,0.0187369882026371,0.536433032616239
"2550","SL Malinga (SL)",275,36,6,42,144,36,180,0.523636363636364,0.130909090909091,0.654545454545455
"2551","SL Watkin (ENG)",25,3,0,3,12,0,12,0.48,0,0.48
"2552","SLV Raju (INDIA)",240,12,0,12,48,0,48,0.2,0,0.2
"2553","SM Curran (ENG)",271,35,4,39,140,24,164,0.516605166051661,0.0885608856088561,0.605166051660517
"2554","SM Ervine (ZIM)",261,32,2,34,128,12,140,0.490421455938697,0.0459770114942529,0.53639846743295
"2555","SM Gavaskar (INDIA)",10168,1023,26,1049,4092,156,4248,0.402439024390244,0.0153422501966955,0.417781274586939
"2556","SM Katich (AUS)",4188,490,9,499,1960,54,2014,0.468003820439351,0.0128939828080229,0.480897803247373
"2557","SM Nurse (WI)",2523,230,11,241,920,66,986,0.364645263575109,0.0261593341260404,0.390804597701149
"2558","SM Patil (INDIA)",1634,197,9,206,788,54,842,0.482252141982864,0.0330477356181151,0.515299877600979
"2559","SM Pollock (SA)",3781,412,35,447,1648,210,1858,0.435863528167152,0.0555408622057657,0.491404390372917
"2560","SM Warnapura (SL)",821,98,2,100,392,12,404,0.477466504263094,0.0146163215590743,0.492082825822168
"2561","SMH Kirmani (INDIA)",2759,246,3,249,984,18,1002,0.356650960492932,0.00652410293584632,0.363175063428779
"2562","SMJ Woods (AUS)",32,0,0,0,0,0,0,0,0,0
"2563","SMJ Woods (ENG)",122,0,0,0,0,0,0,0,0,0
"2564","SMS Kaluperuma (SL)",88,11,0,11,44,0,44,0.5,0,0.5
"2565","SMSM Senanayake (SL)",5,1,0,1,4,0,4,0.8,0,0.8
"2566","SN Banerjee (INDIA)",13,0,1,1,0,6,6,0,0.461538461538462,0.461538461538462
"2567","SN McGregor (NZ)",892,34,0,34,136,0,136,0.152466367713004,0,0.152466367713004
"2568","SNJ O'Keefe (AUS)",86,11,0,11,44,0,44,0.511627906976744,0,0.511627906976744
"2569","SO Dowrich (WI)",1034,122,6,128,488,36,524,0.471953578336557,0.034816247582205,0.506769825918762
"2570","SO Hetmyer (WI)",322,41,6,47,164,36,200,0.509316770186335,0.111801242236025,0.62111801242236
"2571","Sohag Gazi (BDESH)",325,32,11,43,128,66,194,0.393846153846154,0.203076923076923,0.596923076923077
"2572","Sohail Khan (PAK)",252,34,8,42,136,48,184,0.53968253968254,0.19047619047619,0.73015873015873
"2573","Sohail Tanvir (PAK)",17,4,0,4,16,0,16,0.941176470588235,0,0.941176470588235
"2574","Sohrawordi Shuvo (BDESH)",15,1,0,1,4,0,4,0.266666666666667,0,0.266666666666667
"2575","Soumya Sarkar (BDESH)",558,76,3,79,304,18,322,0.544802867383513,0.032258064516129,0.577060931899642
"2576","SP Davis (AUS)",0,0,0,0,0,0,0,NA,NA,NA
"2577","SP Fleming (NZ)",7172,917,26,943,3668,156,3824,0.51143335192415,0.0217512548800892,0.533184606804239
"2578","SP Gupte (INDIA)",183,2,0,2,8,0,8,0.0437158469945355,0,0.0437158469945355
"2579","SP James (ENG)",71,6,0,6,24,0,24,0.338028169014085,0,0.338028169014085
"2580","SP Jones (AUS)",428,31,0,31,124,0,124,0.289719626168224,0,0.289719626168224
"2581","SP Jones (ENG)",205,29,3,32,116,18,134,0.565853658536585,0.0878048780487805,0.653658536585366
"2582","SP Kinneir (ENG)",52,5,0,5,20,0,20,0.384615384615385,0,0.384615384615385
"2583","SP Narine (WI)",40,4,1,5,16,6,22,0.4,0.15,0.55
"2584","SP O'Donnell (AUS)",252,25,3,28,100,18,118,0.396825396825397,0.0714285714285714,0.468253968253968
"2585","SPD Smith (AUS)",6199,684,36,720,2736,216,2952,0.441361509920955,0.0348443297306017,0.476205839651557
"2586","SR Clark (AUS)",248,21,6,27,84,36,120,0.338709677419355,0.145161290322581,0.483870967741935
"2587","SR Gillespie (NZ)",28,2,0,2,8,0,8,0.285714285714286,0,0.285714285714286
"2588","SR Harmer (SA)",58,5,0,5,20,0,20,0.344827586206897,0,0.344827586206897
"2589","SR Patel (ENG)",151,16,1,17,64,6,70,0.423841059602649,0.0397350993377483,0.463576158940397
"2590","SR Patil (INDIA)",14,0,0,0,0,0,0,0,0,0
"2591","SR Tendulkar (INDIA)",15921,2058,69,2127,8232,414,8646,0.517052948935368,0.0260033917467496,0.543056340682118
"2592","SR Thompson (IRE)",56,6,0,6,24,0,24,0.428571428571429,0,0.428571428571429
"2593","SR Watson (AUS)",3731,483,31,514,1932,186,2118,0.517823639774859,0.0498525864379523,0.567676226212812
"2594","SR Waugh (AUS)",10927,1175,20,1195,4700,120,4820,0.430127207833806,0.0109819712638419,0.441109179097648
"2595","SS Cottrell (WI)",11,1,0,1,4,0,4,0.363636363636364,0,0.363636363636364
"2596","SS Das (INDIA)",1326,180,1,181,720,6,726,0.542986425339366,0.00452488687782805,0.547511312217195
"2597","SS Dighe (INDIA)",141,19,0,19,76,0,76,0.539007092198582,0,0.539007092198582
"2598","SS Karim (INDIA)",15,2,0,2,8,0,8,0.533333333333333,0,0.533333333333333
"2599","SS Naik (INDIA)",141,17,0,17,68,0,68,0.482269503546099,0,0.482269503546099
"2600","SS Schultz (ENG)",20,0,0,0,0,0,0,0,0,0
"2601","ST Banerjee (INDIA)",3,0,0,0,0,0,0,0,0,0
"2602","ST Callaway (AUS)",87,9,0,9,36,0,36,0.413793103448276,0,0.413793103448276
"2603","ST Clarke (WI)",172,12,8,20,48,48,96,0.27906976744186,0.27906976744186,0.558139534883721
"2604","ST Finn (ENG)",279,36,0,36,144,0,144,0.516129032258065,0,0.516129032258065
"2605","ST Gabriel (WI)",178,23,4,27,92,24,116,0.51685393258427,0.134831460674157,0.651685393258427
"2606","ST Jayasuriya (SL)",6973,910,59,969,3640,354,3994,0.522013480567905,0.0507672450881973,0.572780725656102
"2607","STR Binny (INDIA)",194,23,1,24,92,6,98,0.474226804123711,0.0309278350515464,0.505154639175258
"2608","Subashis Roy (BDESH)",14,3,0,3,12,0,12,0.857142857142857,0,0.857142857142857
"2609","Sunzamul Islam (BDESH)",24,1,0,1,4,0,4,0.166666666666667,0,0.166666666666667
"2610","Surendranath (INDIA)",136,7,0,7,28,0,28,0.205882352941176,0,0.205882352941176
"2611","SV Bahutule (INDIA)",39,3,1,4,12,6,18,0.307692307692308,0.153846153846154,0.461538461538462
"2612","SV Carlisle (ZIM)",1615,185,10,195,740,60,800,0.458204334365325,0.0371517027863777,0.495356037151703
"2613","SV Manjrekar (INDIA)",1997,218,1,219,872,6,878,0.436654982473711,0.00300450676014021,0.439659489233851
"2614","SV Nayak (INDIA)",19,3,0,3,12,0,12,0.631578947368421,0,0.631578947368421
"2615","SV Samuelson (SA)",22,0,0,0,0,0,0,0,0,0
"2616","SW Ambris (WI)",25,3,1,4,12,6,18,0.48,0.24,0.72
"2617","SW Masakadza (ZIM)",88,9,0,9,36,0,36,0.409090909090909,0,0.409090909090909
"2618","SW Sohoni (INDIA)",83,0,0,0,0,0,0,0,0,0
"2619","SW Tait (AUS)",20,4,0,4,16,0,16,0.8,0,0.8
"2620","Syed Rasel (BDESH)",37,6,0,6,24,0,24,0.648648648648649,0,0.648648648648649
"2621","T Armitage (ENG)",33,1,0,1,4,0,4,0.121212121212121,0,0.121212121212121
"2622","T Bavuma (SA)",1488,183,3,186,732,18,750,0.491935483870968,0.0120967741935484,0.504032258064516
"2623","T Bosch (SA)",5,1,0,1,4,0,4,0.8,0,0.8
"2624","T Campbell (SA)",90,0,0,0,0,0,0,0,0,0
"2625","T Duffin (ZIM)",80,12,0,12,48,0,48,0.6,0,0.6
"2626","T Emmett (ENG)",160,8,1,9,32,6,38,0.2,0.0375,0.2375
"2627","T Greenhough (ENG)",4,0,0,0,0,0,0,0,0,0
"2628","T Maruma (ZIM)",20,2,0,2,8,0,8,0.4,0,0.4
"2629","T Meale (NZ)",21,1,1,2,4,6,10,0.19047619047619,0.285714285714286,0.476190476190476
"2630","T Mupariwa (ZIM)",15,2,0,2,8,0,8,0.533333333333333,0,0.533333333333333
"2631","T Panyangara (ZIM)",201,30,2,32,120,12,132,0.597014925373134,0.0597014925373134,0.656716417910448
"2632","T Richardson (ENG)",177,7,0,7,28,0,28,0.15819209039548,0,0.15819209039548
"2633","T Shamsi (SA)",20,2,0,2,8,0,8,0.4,0,0.4
"2634","T Taibu (ZIM)",1546,182,7,189,728,42,770,0.470892626131953,0.0271668822768435,0.498059508408797
"2635","T Thushara (SL)",94,13,0,13,52,0,52,0.553191489361702,0,0.553191489361702
"2636","T Westley (ENG)",193,33,0,33,132,0,132,0.683937823834197,0,0.683937823834197
"2637","T Yohannan (INDIA)",13,1,0,1,4,0,4,0.307692307692308,0,0.307692307692308
"2638","TA Blundell (NZ)",136,17,1,18,68,6,74,0.5,0.0441176470588235,0.544117647058823
"2639","TA Boult (NZ)",545,53,25,78,212,150,362,0.388990825688073,0.275229357798165,0.664220183486239
"2640","TA Copeland (AUS)",39,7,0,7,28,0,28,0.717948717948718,0,0.717948717948718
"2641","TA Harris (SA)",100,9,0,9,36,0,36,0.36,0,0.36
"2642","TA Lloyd (ENG)",10,1,0,1,4,0,4,0.4,0,0.4
"2643","TA Munton (ENG)",25,3,0,3,12,0,12,0.48,0,0.48
"2644","TA Ward (SA)",451,4,0,4,16,0,16,0.0354767184035477,0,0.0354767184035477
"2645","Tahir Naqqash (PAK)",300,36,1,37,144,6,150,0.48,0.02,0.5
"2646","Taijul Islam (BDESH)",256,35,1,36,140,6,146,0.546875,0.0234375,0.5703125
"2647","Talat Ali (PAK)",370,34,1,35,136,6,142,0.367567567567568,0.0162162162162162,0.383783783783784
"2648","Talha Jubair (BDESH)",52,9,1,10,36,6,42,0.692307692307692,0.115384615384615,0.807692307692308
"2649","TAM Siriwardana (SL)",298,32,11,43,128,66,194,0.429530201342282,0.221476510067114,0.651006711409396
"2650","Tamim Iqbal (BDESH)",4049,494,33,527,1976,198,2174,0.488021733761423,0.0489009632007903,0.536922696962213
"2651","Tanvir Ahmed (PAK)",170,26,0,26,104,0,104,0.611764705882353,0,0.611764705882353
"2652","TAP Sekhar (INDIA)",0,0,0,0,0,0,0,NA,NA,NA
"2653","Tapash Baisya (BDESH)",384,47,2,49,188,12,200,0.489583333333333,0.03125,0.520833333333333
"2654","Tareq Aziz (BDESH)",22,2,0,2,8,0,8,0.363636363636364,0,0.363636363636364
"2655","Taskin Ahmed (BDESH)",68,3,2,5,12,12,24,0.176470588235294,0.176470588235294,0.352941176470588
"2656","Taslim Arif (PAK)",547,48,0,48,192,0,192,0.351005484460695,0,0.351005484460695
"2657","Taufeeq Umar (PAK)",2963,404,4,408,1616,24,1640,0.545393182585218,0.00809989875126561,0.553493081336483
"2658","Tauseef Ahmed (PAK)",318,22,0,22,88,0,88,0.276729559748428,0,0.276729559748428
"2659","TB Burtt (NZ)",252,10,1,11,40,6,46,0.158730158730159,0.0238095238095238,0.182539682539683
"2660","TB de Bruyn (SA)",234,32,0,32,128,0,128,0.547008547008547,0,0.547008547008547
"2661","TB Mitchell (ENG)",20,2,0,2,8,0,8,0.4,0,0.4
"2662","TBA May (AUS)",225,14,0,14,56,0,56,0.248888888888889,0,0.248888888888889
"2663","TC Lowry (NZ)",223,0,0,0,0,0,0,0,0,0
"2664","TC O'Brien (ENG)",59,0,0,0,0,0,0,0,0,0
"2665","TCB Fernando (SL)",132,15,0,15,60,0,60,0.454545454545455,0,0.454545454545455
"2666","TD Astle (NZ)",56,6,0,6,24,0,24,0.428571428571429,0,0.428571428571429
"2667","TD Paine (AUS)",694,78,3,81,312,18,330,0.449567723342939,0.0259365994236311,0.475504322766571
"2668","TE Bailey (ENG)",2290,178,2,180,712,12,724,0.310917030567686,0.00524017467248908,0.316157205240175
"2669","TE Blain (NZ)",456,62,4,66,248,24,272,0.543859649122807,0.0526315789473684,0.596491228070175
"2670","TE Kane (IRE)",14,1,0,1,4,0,4,0.285714285714286,0,0.285714285714286
"2671","TE Srinivasan (INDIA)",48,6,0,6,24,0,24,0.5,0,0.5
"2672","TF Johnson (WI)",9,0,0,0,0,0,0,0,0,0
"2673","TF Smailes (ENG)",25,0,0,0,0,0,0,0,0,0
"2674","TG Evans (ENG)",2439,202,7,209,808,42,850,0.331283312833128,0.017220172201722,0.34850348503485
"2675","TG Hogan (AUS)",205,22,0,22,88,0,88,0.429268292682927,0,0.429268292682927
"2676","TG McIntosh (NZ)",854,98,7,105,392,42,434,0.459016393442623,0.0491803278688525,0.508196721311475
"2677","TG McMahon (NZ)",7,0,0,0,0,0,0,0,0,0
"2678","TG Southee (NZ)",1459,148,64,212,592,384,976,0.405757368060315,0.263193968471556,0.668951336531871
"2679","TJ Franklin (NZ)",828,83,1,84,332,6,338,0.400966183574879,0.0072463768115942,0.408212560386473
"2680","TJ Friend (ZIM)",447,54,3,57,216,18,234,0.483221476510067,0.0402684563758389,0.523489932885906
"2681","TJ Jenner (AUS)",208,17,0,17,68,0,68,0.326923076923077,0,0.326923076923077
"2682","TJ Laughlin (AUS)",87,7,0,7,28,0,28,0.32183908045977,0,0.32183908045977
"2683","TJ Matthews (AUS)",153,8,0,8,32,0,32,0.209150326797386,0,0.209150326797386
"2684","TJ Murtagh (IRE)",10,2,0,2,8,0,8,0.8,0,0.8
"2685","TJ Zoehrer (AUS)",246,30,2,32,120,12,132,0.48780487804878,0.0487804878048781,0.536585365853659
"2686","TJD Kelly (AUS)",64,8,0,8,32,0,32,0.5,0,0.5
"2687","TJE Andrews (AUS)",588,49,0,49,196,0,196,0.333333333333333,0,0.333333333333333
"2688","TK Curran (ENG)",66,12,0,12,48,0,48,0.727272727272727,0,0.727272727272727
"2689","TK Kendall (AUS)",39,3,0,3,12,0,12,0.307692307692308,0,0.307692307692308
"2690","TK Musakanda (ZIM)",6,1,0,1,4,0,4,0.666666666666667,0,0.666666666666667
"2691","TL Best (WI)",401,52,5,57,208,30,238,0.518703241895262,0.0748129675810474,0.593516209476309
"2692","TL Chatara (ZIM)",82,12,1,13,48,6,54,0.585365853658537,0.0731707317073171,0.658536585365854
"2693","TL Goddard (SA)",2516,154,6,160,616,36,652,0.24483306836248,0.014308426073132,0.259141494435612
"2694","TL Richmond (ENG)",2,0,0,0,0,0,0,0,0,0
"2695","TL Tsolekile (SA)",47,3,0,3,12,0,12,0.25531914893617,0,0.25531914893617
"2696","TM Alderman (AUS)",203,19,0,19,76,0,76,0.374384236453202,0,0.374384236453202
"2697","TM Chappell (AUS)",79,3,0,3,12,0,12,0.151898734177215,0,0.151898734177215
"2698","TM Dilshan (SL)",5492,677,24,701,2708,144,2852,0.493080844865259,0.0262199563000728,0.519300801165331
"2699","TM Dowlin (WI)",343,41,1,42,164,6,170,0.478134110787172,0.0174927113702624,0.495626822157434
"2700","TM Findlay (WI)",212,19,0,19,76,0,76,0.358490566037736,0,0.358490566037736
"2701","TM Moody (AUS)",456,49,0,49,196,0,196,0.429824561403509,0,0.429824561403509
"2702","TMK Mawoyo (ZIM)",615,78,0,78,312,0,312,0.507317073170732,0,0.507317073170732
"2703","TN Madondo (ZIM)",90,10,0,10,40,0,40,0.444444444444444,0,0.444444444444444
"2704","TP Horan (AUS)",471,27,1,28,108,6,114,0.229299363057325,0.0127388535031847,0.24203821656051
"2705","TP Kamungozi (ZIM)",5,0,0,0,0,0,0,0,0,0
"2706","TPB Smith (ENG)",33,2,0,2,8,0,8,0.242424242424242,0,0.242424242424242
"2707","TR Ambrose (ENG)",447,55,4,59,220,24,244,0.492170022371365,0.0536912751677852,0.54586129753915
"2708","TR Gripper (ZIM)",809,96,2,98,384,12,396,0.474660074165637,0.0148331273176761,0.489493201483313
"2709","TR McKibbin (AUS)",88,0,0,0,0,0,0,0,0,0
"2710","TR Veivers (AUS)",813,72,6,78,288,36,324,0.354243542435424,0.044280442804428,0.398523985239852
"2711","TRO Payne (WI)",5,0,0,0,0,0,0,0,0,0
"2712","TS Chisoro (ZIM)",9,1,0,1,4,0,4,0.444444444444444,0,0.444444444444444
"2713","TS Curtis (ENG)",140,20,0,20,80,0,80,0.571428571428571,0,0.571428571428571
"2714","TS Roland-Jones (ENG)",82,10,3,13,40,18,58,0.48780487804878,0.219512195121951,0.707317073170732
"2715","TS Worthington (ENG)",321,29,0,29,116,0,116,0.361370716510903,0,0.361370716510903
"2716","TT Bresnan (ENG)",575,67,1,68,268,6,274,0.466086956521739,0.0104347826086957,0.476521739130435
"2717","TT Samaraweera (SL)",5462,633,7,640,2532,42,2574,0.463566459172464,0.00768949102892713,0.471255950201391
"2718","TU Groube (AUS)",11,1,0,1,4,0,4,0.363636363636364,0,0.363636363636364
"2719","Tushar Imran (BDESH)",89,12,0,12,48,0,48,0.539325842696629,0,0.539325842696629
"2720","TV Hohns (AUS)",136,17,0,17,68,0,68,0.5,0,0.5
"2721","TW Cartwright (ENG)",26,3,0,3,12,0,12,0.461538461538462,0,0.461538461538462
"2722","TW Garrett (AUS)",339,12,1,13,48,6,54,0.141592920353982,0.0176991150442478,0.15929203539823
"2723","TW Graveney (ENG)",4882,425,7,432,1700,42,1742,0.348217943465793,0.008603031544449,0.356820975010242
"2724","TW Hayward (ENG)",1999,143,0,143,572,0,572,0.286143071535768,0,0.286143071535768
"2725","TW Jarvis (NZ)",625,63,0,63,252,0,252,0.4032,0,0.4032
"2726","TW Routledge (SA)",72,0,0,0,0,0,0,0,0,0
"2727","TW Wall (AUS)",121,7,1,8,28,6,34,0.231404958677686,0.0495867768595041,0.28099173553719
"2728","TWJ Goddard (ENG)",13,0,0,0,0,0,0,0,0,0
"2729","TWM Latham (NZ)",2404,283,7,290,1132,42,1174,0.470881863560732,0.0174708818635607,0.488352745424293
"2730","U Afzaal (ENG)",83,12,0,12,48,0,48,0.578313253012048,0,0.578313253012048
"2731","U Ranchod (ZIM)",8,1,0,1,4,0,4,0.5,0,0.5
"2732","UC Hathurusingha (SL)",1274,154,0,154,616,0,616,0.483516483516484,0,0.483516483516484
"2733","UDU Chandana (SL)",616,77,6,83,308,36,344,0.5,0.0584415584415584,0.558441558441558
"2734","UG Dowe (WI)",8,1,0,1,4,0,4,0.5,0,0.5
"2735","Umar Akmal (PAK)",1003,117,17,134,468,102,570,0.466600199401795,0.101694915254237,0.568295114656032
"2736","Umar Amin (PAK)",99,13,0,13,52,0,52,0.525252525252525,0,0.525252525252525
"2737","Umar Gul (PAK)",577,63,20,83,252,120,372,0.436741767764298,0.207972270363951,0.64471403812825
"2738","UN Kulkarni (INDIA)",13,1,0,1,4,0,4,0.307692307692308,0,0.307692307692308
"2739","Usman Salahuddin (PAK)",37,2,0,2,8,0,8,0.216216216216216,0,0.216216216216216
"2740","UT Khawaja (AUS)",2226,244,14,258,976,84,1060,0.438454627133872,0.0377358490566038,0.476190476190476
"2741","UT Yadav (INDIA)",253,31,7,38,124,42,166,0.490118577075099,0.16600790513834,0.656126482213439
"2742","UWMBCA Welegedara (SL)",218,30,4,34,120,24,144,0.55045871559633,0.110091743119266,0.660550458715596
"2743","V Dahiya (INDIA)",2,0,0,0,0,0,0,0,0,0
"2744","V Kohli (INDIA)",6098,679,18,697,2716,108,2824,0.445391931780912,0.0177107248278124,0.463102656608724
"2745","V Permaul (WI)",98,14,2,16,56,12,68,0.571428571428571,0.122448979591837,0.693877551020408
"2746","V Pollard (NZ)",1266,124,4,128,496,24,520,0.391785150078989,0.018957345971564,0.410742496050553
"2747","V Rathour (INDIA)",131,13,0,13,52,0,52,0.396946564885496,0,0.396946564885496
"2748","V Razdan (INDIA)",6,1,0,1,4,0,4,0.666666666666667,0,0.666666666666667
"2749","V Sehwag (ICC)",83,14,1,15,56,6,62,0.674698795180723,0.072289156626506,0.746987951807229
"2750","V Sehwag (INDIA)",8503,1219,90,1309,4876,540,5416,0.573444666588263,0.0635069975302834,0.636951664118546
"2751","V Sibanda (ZIM)",591,86,6,92,344,36,380,0.582064297800338,0.0609137055837563,0.642978003384095
"2752","V Subramanya (INDIA)",263,32,1,33,128,6,134,0.486692015209125,0.0228136882129278,0.509505703422053
"2753","V Yadav (INDIA)",30,3,2,5,12,12,24,0.4,0.4,0.8
"2754","VA Barton (ENG)",23,0,1,1,0,6,6,0,0.260869565217391,0.260869565217391
"2755","VA Holder (WI)",682,47,8,55,188,48,236,0.275659824046921,0.0703812316715543,0.346041055718475
"2756","VA Singh (WI)",63,4,0,4,16,0,16,0.253968253968254,0,0.253968253968254
"2757","VA Valentine (WI)",35,0,0,0,0,0,0,0,0,0
"2758","VB John (SL)",53,3,1,4,12,6,18,0.226415094339623,0.113207547169811,0.339622641509434
"2759","VB Ranjane (INDIA)",40,0,1,1,0,6,6,0,0.15,0.15
"2760","VC Drakes (WI)",386,54,7,61,216,42,258,0.559585492227979,0.10880829015544,0.66839378238342
"2761","VD Philander (SA)",1485,168,15,183,672,90,762,0.452525252525253,0.0606060606060606,0.513131313131313
"2762","VG Kambli (INDIA)",1084,124,6,130,496,36,532,0.457564575645756,0.033210332103321,0.490774907749078
"2763","VH Stollmeyer (WI)",96,11,0,11,44,0,44,0.458333333333333,0,0.458333333333333
"2764","VI Smith (SA)",39,0,0,0,0,0,0,0,0,0
"2765","Vizianagram (INDIA)",33,0,0,0,0,0,0,0,0,0
"2766","VJ Marks (ENG)",249,23,0,23,92,0,92,0.369477911646586,0,0.369477911646586
"2767","VJ Scott (NZ)",458,16,0,16,64,0,64,0.139737991266376,0,0.139737991266376
"2768","VL Manjrekar (INDIA)",3208,197,0,197,788,0,788,0.245635910224439,0,0.245635910224439
"2769","VL Mehra (INDIA)",329,16,0,16,64,0,64,0.194528875379939,0,0.194528875379939
"2770","VM Merchant (INDIA)",859,39,0,39,156,0,156,0.181606519208382,0,0.181606519208382
"2771","VM Muddiah (INDIA)",11,0,0,0,0,0,0,0,0,0
"2772","VM Tancred (SA)",25,0,0,0,0,0,0,0,0,0
"2773","VP Terry (ENG)",16,2,0,2,8,0,8,0.5,0,0.5
"2774","VPFA Royle (ENG)",21,0,0,0,0,0,0,0,0,0
"2775","VR Aaron (INDIA)",35,4,0,4,16,0,16,0.457142857142857,0,0.457142857142857
"2776","VR Brown (NZ)",51,3,0,3,12,0,12,0.235294117647059,0,0.235294117647059
"2777","VRV Singh (INDIA)",47,9,0,9,36,0,36,0.765957446808511,0,0.765957446808511
"2778","VS Hazare (INDIA)",2192,110,1,111,440,6,446,0.200729927007299,0.00273722627737226,0.203467153284672
"2779","VS Ransford (AUS)",1219,92,1,93,368,6,374,0.30188679245283,0.00492206726825267,0.306808859721083
"2780","VT Trumper (AUS)",3163,260,4,264,1040,24,1064,0.328801770471072,0.00758773316471704,0.336389503635789
"2781","VV Kumar (INDIA)",6,0,0,0,0,0,0,0,0,0
"2782","VVS Laxman (INDIA)",8781,1135,5,1140,4540,30,4570,0.517025395740804,0.00341646737273659,0.520441863113541
"2783","VWC Jupp (ENG)",208,8,0,8,32,0,32,0.153846153846154,0,0.153846153846154
"2784","VY Richardson (AUS)",702,63,1,64,252,6,258,0.358974358974359,0.00854700854700855,0.367521367521368
"2785","W Attewell (ENG)",150,13,0,13,52,0,52,0.346666666666667,0,0.346666666666667
"2786","W Barber (ENG)",83,0,0,0,0,0,0,0,0,0
"2787","W Bardsley (AUS)",2469,187,3,190,748,18,766,0.302956662616444,0.00729040097205346,0.310247063588497
"2788","W Barnes (ENG)",725,36,0,36,144,0,144,0.198620689655172,0,0.198620689655172
"2789","W Bates (ENG)",656,53,4,57,212,24,236,0.323170731707317,0.0365853658536585,0.359756097560976
"2790","W Bell (NZ)",21,0,0,0,0,0,0,0,0,0
"2791","W Brearley (ENG)",21,0,0,0,0,0,0,0,0,0
"2792","W Brockwell (ENG)",202,10,0,10,40,0,40,0.198019801980198,0,0.198019801980198
"2793","W Bruce (AUS)",702,38,2,40,152,12,164,0.216524216524217,0.0170940170940171,0.233618233618234
"2794","W Carkeek (AUS)",20,0,0,0,0,0,0,0,0,0
"2795","W Chatterton (ENG)",48,0,0,0,0,0,0,0,0,0
"2796","W Farrimond (ENG)",116,4,0,4,16,0,16,0.137931034482759,0,0.137931034482759
"2797","W Ferguson (WI)",200,0,0,0,0,0,0,0,0,0
"2798","W Flowers (ENG)",254,13,0,13,52,0,52,0.204724409448819,0,0.204724409448819
"2799","W Gunn (ENG)",392,9,0,9,36,0,36,0.0918367346938776,0,0.0918367346938776
"2800","W Jaffer (INDIA)",1944,272,3,275,1088,18,1106,0.559670781893004,0.00925925925925926,0.568930041152263
"2801","W Larkins (ENG)",447,45,1,46,180,6,186,0.402684563758389,0.0134228187919463,0.416107382550336
"2802","W Mathias (PAK)",783,25,0,25,100,0,100,0.127713920817369,0,0.127713920817369
"2803","W Mead (ENG)",7,0,0,0,0,0,0,0,0,0
"2804","W Mwayenga (ZIM)",15,1,1,2,4,6,10,0.266666666666667,0.4,0.666666666666667
"2805","W Newham (ENG)",26,2,0,2,8,0,8,0.307692307692308,0,0.307692307692308
"2806","W Place (ENG)",144,0,0,0,0,0,0,0,0,0
"2807","W Rhodes (ENG)",2325,109,1,110,436,6,442,0.18752688172043,0.00258064516129032,0.19010752688172
"2808","W Storer (ENG)",215,20,1,21,80,6,86,0.372093023255814,0.027906976744186,0.4
"2809","W Voce (ENG)",308,7,8,15,28,48,76,0.0909090909090909,0.155844155844156,0.246753246753247
"2810","W Watson (ENG)",879,71,2,73,284,12,296,0.323094425483504,0.0136518771331058,0.33674630261661
"2811","W Watson (NZ)",60,7,0,7,28,0,28,0.466666666666667,0,0.466666666666667
"2812","WA Brown (AUS)",1592,85,1,86,340,6,346,0.21356783919598,0.00376884422110553,0.217336683417085
"2813","WA Hadlee (NZ)",543,37,0,37,148,0,148,0.27255985267035,0,0.27255985267035
"2814","WA Hunt (AUS)",0,0,0,0,0,0,0,NA,NA,NA
"2815","WA Johnston (AUS)",273,24,0,24,96,0,96,0.351648351648352,0,0.351648351648352
"2816","WA Shalders (SA)",355,18,0,18,72,0,72,0.202816901408451,0,0.202816901408451
"2817","Wafadar Momand (AFG)",6,1,0,1,4,0,4,0.666666666666667,0,0.666666666666667
"2818","Wahab Riaz (PAK)",299,31,5,36,124,30,154,0.414715719063545,0.100334448160535,0.51505016722408
"2819","Wajahatullah Wasti (PAK)",329,38,3,41,152,18,170,0.462006079027356,0.0547112462006079,0.516717325227964
"2820","Waqar Hasan (PAK)",1071,38,1,39,152,6,158,0.141923436041083,0.00560224089635854,0.147525676937442
"2821","Waqar Younis (PAK)",1010,133,16,149,532,96,628,0.526732673267327,0.0950495049504951,0.621782178217822
"2822","WAS Oldfield (AUS)",1423,79,1,80,316,6,322,0.222066057624736,0.00421644413211525,0.226282501756852
"2823","Wasim Akram (PAK)",2898,324,57,381,1296,342,1638,0.447204968944099,0.118012422360248,0.565217391304348
"2824","Wasim Bari (PAK)",1366,106,2,108,424,12,436,0.310395314787701,0.00878477306002928,0.319180087847731
"2825","Wasim Raja (PAK)",2821,291,27,318,1164,162,1326,0.41261963842609,0.0574264445232187,0.470046082949309
"2826","Wazir Mohammad (PAK)",801,47,0,47,188,0,188,0.234706616729089,0,0.234706616729089
"2827","WB Phillips (AUS)",1531,175,5,180,700,30,730,0.457217504898759,0.0195950359242325,0.476812540822992
"2828","WB Rankin (ENG)",13,2,0,2,8,0,8,0.615384615384615,0,0.615384615384615
"2829","WB Rankin (IRE)",23,3,0,3,12,0,12,0.521739130434783,0,0.521739130434783
"2830","WD Parnell (SA)",67,11,0,11,44,0,44,0.656716417910448,0,0.656716417910448
"2831","WE Astill (ENG)",190,8,0,8,32,0,32,0.168421052631579,0,0.168421052631579
"2832","WE Bowes (ENG)",28,0,0,0,0,0,0,0,0,0
"2833","WE Hollies (ENG)",37,0,0,0,0,0,0,0,0,0
"2834","WE Merritt (NZ)",73,0,0,0,0,0,0,0,0,0
"2835","WE Midwinter (AUS)",174,7,0,7,28,0,28,0.160919540229885,0,0.160919540229885
"2836","WE Midwinter (ENG)",95,7,1,8,28,6,34,0.294736842105263,0.0631578947368421,0.357894736842105
"2837","WE Russell (ENG)",362,32,0,32,128,0,128,0.353591160220994,0,0.353591160220994
"2838","WF Giffen (AUS)",11,0,0,0,0,0,0,0,0,0
"2839","WFE Marx (SA)",125,16,0,16,64,0,64,0.512,0,0.512
"2840","WFF Price (ENG)",6,1,0,1,4,0,4,0.666666666666667,0,0.666666666666667
"2841","WG Grace (ENG)",1098,55,1,56,220,6,226,0.200364298724954,0.00546448087431694,0.205828779599271
"2842","WG Quaife (ENG)",228,10,0,10,40,0,40,0.175438596491228,0,0.175438596491228
"2843","WGA Parkhouse (ENG)",373,17,0,17,68,0,68,0.18230563002681,0,0.18230563002681
"2844","WH Ashley (SA)",1,0,0,0,0,0,0,0,0,0
"2845","WH Brann (SA)",67,0,0,0,0,0,0,0,0,0
"2846","WH Cooper (AUS)",13,0,0,0,0,0,0,0,0,0
"2847","WH Copson (ENG)",6,0,0,0,0,0,0,0,0,0
"2848","WH Lockwood (ENG)",231,7,0,7,28,0,28,0.121212121212121,0,0.121212121212121
"2849","WH Milton (SA)",68,3,0,3,12,0,12,0.176470588235294,0,0.176470588235294
"2850","WH Moule (AUS)",40,4,0,4,16,0,16,0.4,0,0.4
"2851","WH Ponsford (AUS)",2118,159,0,159,636,0,636,0.30028328611898,0,0.30028328611898
"2852","WH Scotton (ENG)",510,26,0,26,104,0,104,0.203921568627451,0,0.203921568627451
"2853","WH St Hill (WI)",117,0,0,0,0,0,0,0,0,0
"2854","WHB Frank (SA)",7,0,0,0,0,0,0,0,0,0
"2855","WHM Richards (SA)",4,0,0,0,0,0,0,0,0,0
"2856","WHV Levett (ENG)",7,0,0,0,0,0,0,0,0,0
"2857","WJ Cronje (SA)",3714,409,33,442,1636,198,1834,0.440495422724825,0.0533117932148627,0.493807215939688
"2858","WJ Edrich (ENG)",2440,244,9,253,976,54,1030,0.4,0.0221311475409836,0.422131147540984
"2859","WJ Edwards (AUS)",68,6,0,6,24,0,24,0.352941176470588,0,0.352941176470588
"2860","WJ O'Reilly (AUS)",410,16,11,27,64,66,130,0.15609756097561,0.160975609756098,0.317073170731707
"2861","WJ Watson (AUS)",106,2,0,2,8,0,8,0.0754716981132075,0,0.0754716981132075
"2862","WJ Whitty (AUS)",161,12,0,12,48,0,48,0.298136645962733,0,0.298136645962733
"2863","WK Hegg (ENG)",30,1,0,1,4,0,4,0.133333333333333,0,0.133333333333333
"2864","WK Lees (NZ)",778,90,5,95,360,30,390,0.462724935732648,0.038560411311054,0.501285347043702
"2865","WKM Benjamin (WI)",470,51,8,59,204,48,252,0.434042553191489,0.102127659574468,0.536170212765957
"2866","WL Cornford (ENG)",36,0,1,1,0,6,6,0,0.166666666666667,0.166666666666667
"2867","WL Murdoch (AUS)",896,69,0,69,276,0,276,0.308035714285714,0,0.308035714285714
"2868","WL Murdoch (ENG)",12,0,0,0,0,0,0,0,0,0
"2869","WM Anderson (NZ)",5,0,0,0,0,0,0,0,0,0
"2870","WM Bradley (ENG)",23,0,0,0,0,0,0,0,0,0
"2871","WM Clark (AUS)",98,10,0,10,40,0,40,0.408163265306122,0,0.408163265306122
"2872","WM Darling (AUS)",697,61,1,62,244,6,250,0.350071736011478,0.00860832137733142,0.358680057388809
"2873","WM Lawry (AUS)",5234,458,15,473,1832,90,1922,0.350019105846389,0.0171952617500955,0.367214367596485
"2874","WM Wallace (NZ)",439,25,2,27,100,12,112,0.227790432801822,0.0273348519362187,0.255125284738041
"2875","WM Woodfull (AUS)",2300,117,0,117,468,0,468,0.203478260869565,0,0.203478260869565
"2876","WN Phillips (AUS)",22,3,0,3,12,0,12,0.545454545454545,0,0.545454545454545
"2877","WN Slack (ENG)",81,9,0,9,36,0,36,0.444444444444444,0,0.444444444444444
"2878","WP Bradburn (NZ)",62,4,0,4,16,0,16,0.258064516129032,0,0.258064516129032
"2879","WP Howell (AUS)",158,11,1,12,44,6,50,0.278481012658228,0.0379746835443038,0.316455696202532
"2880","WP Saha (INDIA)",1164,108,12,120,432,72,504,0.371134020618557,0.0618556701030928,0.43298969072165
"2881","WPA Crawford (AUS)",53,0,1,1,0,6,6,0,0.113207547169811,0.113207547169811
"2882","WPUJC Vaas (SL)",3089,376,16,392,1504,96,1600,0.486888960828747,0.031078018776303,0.51796697960505
"2883","WR Cuttell (ENG)",65,0,0,0,0,0,0,0,0,0
"2884","WR Endean (SA)",1630,90,1,91,360,6,366,0.220858895705521,0.00368098159509202,0.224539877300614
"2885","WR Hammond (ENG)",7249,512,27,539,2048,162,2210,0.282521727134777,0.0223479100565595,0.304869637191337
"2886","WR James (ZIM)",61,7,0,7,28,0,28,0.459016393442623,0,0.459016393442623
"2887","WR Playle (NZ)",151,6,0,6,24,0,24,0.158940397350993,0,0.158940397350993
"2888","WR Robertson (AUS)",2,0,0,0,0,0,0,0,0,0
"2889","WRS de Silva (SL)",10,2,0,2,8,0,8,0.8,0,0.8
"2890","WRT Solomon (SA)",4,0,0,0,0,0,0,0,0,0
"2891","WS Farrer (SA)",221,19,0,19,76,0,76,0.343891402714932,0,0.343891402714932
"2892","WS Lees (ENG)",66,9,0,9,36,0,36,0.545454545454545,0,0.545454545454545
"2893","WTS Porterfield (IRE)",33,3,0,3,12,0,12,0.363636363636364,0,0.363636363636364
"2894","WU Tharanga (SL)",1754,239,9,248,956,54,1010,0.545039908779932,0.0307867730900798,0.575826681870011
"2895","WV Raman (INDIA)",448,55,1,56,220,6,226,0.491071428571429,0.0133928571428571,0.504464285714286
"2896","WV Rodriguez (WI)",96,2,1,3,8,6,14,0.0833333333333333,0.0625,0.145833333333333
"2897","WVS Ling (SA)",168,13,1,14,52,6,58,0.30952380952381,0.0357142857142857,0.345238095238095
"2898","WW Armstrong (AUS)",2867,202,7,209,808,42,850,0.281827694454133,0.0146494593651901,0.296477153819323
"2899","WW Daniel (WI)",46,2,2,4,8,12,20,0.173913043478261,0.260869565217391,0.434782608695652
"2900","WW Davis (WI)",202,19,3,22,76,18,94,0.376237623762376,0.0891089108910891,0.465346534653465
"2901","WW Hall (WI)",818,50,6,56,200,36,236,0.244498777506112,0.0440097799511002,0.288508557457213
"2902","WW Hinds (WI)",2562,367,16,383,1468,96,1564,0.572989851678376,0.0374707259953162,0.610460577673692
"2903","WW Keeton (ENG)",57,0,0,0,0,0,0,0,0,0
"2904","WW Read (ENG)",720,62,0,62,248,0,248,0.344444444444444,0,0.344444444444444
"2905","WW Wade (SA)",511,7,1,8,28,6,34,0.0547945205479452,0.0117416829745597,0.0665362035225049
"2906","WW Whysall (ENG)",209,13,1,14,52,6,58,0.248803827751196,0.0287081339712919,0.277511961722488
"2907","XC Balaskas (SA)",174,0,0,0,0,0,0,0,0,0
"2908","XJ Doherty (AUS)",51,8,0,8,32,0,32,0.627450980392157,0,0.627450980392157
"2909","XM Marshall (WI)",243,37,2,39,148,12,160,0.609053497942387,0.0493827160493827,0.65843621399177
"2910","Y Goonasekera (SL)",48,3,0,3,12,0,12,0.25,0,0.25
"2911","Yajurvindra Singh (INDIA)",109,9,0,9,36,0,36,0.330275229357798,0,0.330275229357798
"2912","Yamin Ahmadzai (AFG)",1,0,0,0,0,0,0,0,0,0
"2913","Yashpal Sharma (INDIA)",1652,144,7,151,576,42,618,0.348668280871671,0.0254237288135593,0.37409200968523
"2914","Yasir Ali (PAK)",1,0,0,0,0,0,0,0,0,0
"2915","Yasir Arafat (PAK)",94,9,2,11,36,12,48,0.382978723404255,0.127659574468085,0.51063829787234
"2916","Yasir Hameed (PAK)",1491,223,4,227,892,24,916,0.598256203890007,0.0160965794768612,0.614352783366868
"2917","Yasir Shah (PAK)",445,48,6,54,192,36,228,0.431460674157303,0.0808988764044944,0.512359550561798
"2918","Younis Ahmed (PAK)",177,17,0,17,68,0,68,0.384180790960452,0,0.384180790960452
"2919","Younis Khan (PAK)",10053,1074,69,1143,4296,414,4710,0.427335123843629,0.0411817367949866,0.468516860638615
"2920","Yuvraj of Patiala (INDIA)",84,0,0,0,0,0,0,0,0,0
"2921","Yuvraj Singh (INDIA)",1900,260,22,282,1040,132,1172,0.547368421052632,0.0694736842105263,0.616842105263158
"2922","Z de Bruyn (SA)",155,12,3,15,48,18,66,0.309677419354839,0.116129032258065,0.425806451612903
"2923","Z Khan (INDIA)",1185,137,26,163,548,156,704,0.462447257383966,0.131645569620253,0.594092827004219
"2924","Zaheer Abbas (PAK)",5108,516,23,539,2064,138,2202,0.40407204385278,0.0270164447924824,0.431088488645262
"2925","Zahid Fazal (PAK)",288,38,0,38,152,0,152,0.527777777777778,0,0.527777777777778
"2926","Zahoor Elahi (PAK)",30,4,1,5,16,6,22,0.533333333333333,0.2,0.733333333333333
"2927","Zakir Khan (PAK)",9,0,0,0,0,0,0,0,0,0
"2928","Ziaur Rahman (BDESH)",14,2,0,2,8,0,8,0.571428571428571,0,0.571428571428571
"2929","ZS Ansari (ENG)",49,5,0,5,20,0,20,0.408163265306122,0,0.408163265306122
"2930","Zulfiqar Ahmed (PAK)",200,7,2,9,28,12,40,0.14,0.06,0.2
"2931","Zulfiqar Babar (PAK)",144,15,4,19,60,24,84,0.416666666666667,0.166666666666667,0.583333333333333
"2932","Zulqarnain (PAK)",24,0,0,0,0,0,0,0,0,0
"2933","Zulqarnain Haider (PAK)",88,15,0,15,60,0,60,0.681818181818182,0,0.681818181818182
